Mm, Mm, Mm, Mm, Mm, Gd, Mm, Gd, Mm, Mm, Mm, Mm, Mm, Mm, Mm, Mm, Mm, Mm, Mm, Mm, Mm, Mm, Hh^Fp, Gd, Hh, Hh, Gs, Re, Gs, Gs, Gs, Wwg, Wog, Wwg, Gs, Gs, Gll^Fp, Hh, Hh^Fp, Mm, Mm, Gs
Mm, Mm, Mm, Mm, Mm, Mm, Mm, Mm, Mm, Mm, Mm, Mm, Mm, Mm, Mm, Mm, Mm, Mm, Mm, Wwg, Wwg, Hh, Hh, Hh, Hh, Gs^Fms, Re, Re, Gs, Gs, Wog, Wog, Wog, Wog, Gs, Gll, Hh^Fp, Hh^Fp, Mm, Mm, Mm, Mm
Mm, Mm, Mm, Mm, Mm, Mm, Mm, Mm, Mm, Mm, Mm, Mm, Mm, Mm, Mm, Mm, Mm, Mm, Hh^Fp, Hh, Hh, Wwg, Gs, Gll^Edt, Hh, Hh, Re, Gs, Gs, Wwg, Wog, Wog, Gs, Gs, Gll, Gll^Fp, Hh, Hh, Mm, Mm, Hh, Mm
Mm, Mm, Hh^Fp, Mm, Mm, Mm, Mm, Mm, Mm, Mm, Mm, Mm, Mm, Mm, Hh, Mm, Hh, Mm, Hh^Fp, Gll^Fp, Gll^Fp, Wwg, Wwg, Gs, Gs, Gs, Gs^Vhr, Gll^Gvs, Gs, Wog, Wog, Wog, Gs, Gll, Gll^Em, Hh, Hh, Hh^Fp, Gll^Fp, Hh^Fp, Hh^Fp, Hh
Hh^Fp, Mm, Hh^Fp, Mm, Mm, Mm, Mm, Mm, Mm, Mm, Mm, Mm, Mm, Mm, Hh^Fp, Hh^Fp, Ch, Ch, Chr, Gll^Fp, Gll^Edt, Gll, Gll, Wwg, Re, Re, Gs^Gvs, Gll^Gvs, Gs, Wog, Wog, Gs, Gs, Gll, Gll^Fp, Hh^Fp, Gll^Em, Hh^Fp, Gll^Em, Gll^Fp, Gll^Fp, Hh
Hh^Fp, Hh^Fp, Hh^Fp, Hh^Fp, Hh^Fp, Mm, Mm, Mm, Mm, Mm, Mm, Mm, Mm, Mm, Mm, Hh^Fp, Ch, 3 Khr, Ch, Gll^Edt, Re, Re, Re, Wwg^Bp/, Wwg, Gs, Wwg, Gs, Wwg, Wog, Wog, Wwg, Gs, Gs, Gll, Gll^Fp, Gll, Gll, Hh, Gll^Fp, Hh, Hh
Mm, Mm, Mm, Mm, Hh^Fp, Hh^Fp, Hh, Hh, Mm, Mm, Hh, Mm, Hh, Mm, Hh, Gll^Fp, Gll^Edt, Chr^Edt, Re, Re, Gs^Edt, Gs, Gll, Gs, Gs, Wwg, Gs, Wwg, Gs, Gs, Wog, Wog, Wwg, Gs, Gs^Gvs, Gll^Gvs, Gll, Gll^Fp, Hh^Fp, Hh, Mm, Mm
Mm, Mm, Hh, Hh, Gll^Gvs, Gs^Fp, Gs, Hh, Re, Re, Mm, Hh, Mm, Hh, Hh, Gll^Fp, Gll^Fp, Gll^Edt, Re, Gs^Edt, Hh^Fms, Gll^Fms, Hh^Fms, Gll^Fms, Gll, Gs^Edt, Gll^Gvs, Gs, Gs, Gs, Wog, Wog, Gs, Gs, Re, Re^Wm, Gll^Fp, Hh^Fp, Hh^Fp, Hh^Fp, Mm, Mm
Mm, Mm, Hh, Gs, Gll^Gvs, Gll^Gvs, Gll^Gvs, Re, Gll^Gvs, Hh^Fp, Hh^Fp, Mm, Mm, Mm, Mm, Gll^Fp, Gll^Fp, Re^Vhr, Re, Gs^Edt, Gll, Hh^Fms, Hh^Fms, Gll^Fms, Re, Gs^Vhr, Gll^Gvs, Gll^Gvs, Gs, Wwg, Wog, Wog, Gs, Gs, Re, Gll^Gvs, Gll, Gll^Fp, Gll^Fp, Mm, Mm, Mm
Mm, Mm, Gll^Gvs, Gs, Gs, Gll^Gvs, Re, Gs^Wm, Hh, Hh^Fp, Mm, Mm, Mm, Mm, Mm, Hh, Hh, Gll^Gvs, Gll^Gvs, Re, Re, Gll^Fms, Gs^Fms, Re, Gll^Edt, Gs^Edt, Gs, Gs, Wog, Wog, Wwg, Wwg, Gs, Re, Gll, Gll^Fp, Hh^Fp, Gll^Fp, Hh, Gll^Fp, Mm, Mm
Gs, Gll^Gvs, Gll^Gvs, Gs, Re, Re, Re, Gs, Gs, Hh, Hh, Hh, Mm, Mm, Mm, Mm, Hh, Gll^Fp, Hh^Fp, Gs, Re, Gs, Re, Re, Gll, Gs, Wog, Wog, Wog, Wog, Gs, Gs, Re, Re^Vc, Hh, Gll^Fp, Hh^Fp, Hh^Fp, Mm, Hh, Mm, Mm
Mm, Hh, Hh, Gs^Vc, Hh, Gs, Gs, Re, Gs, Gll^Gvs, Hh, Hh, Mm, Mm, Mm, Mm, Mm, Mm, Hh^Fp, Gs^Fp, Gs, Re, Gs^Edt, Gll, Gs, Wog, Wog, Wog, Gs, Gs, Gll^Fp, Gll^Fp, Gll^Fp, Hh, Mm, Hh, Hh, Hh^Fp, Gll^Em, Mm, Mm, Mm
Mm, Mm, Mm, Hh, Hh, Hh, Gs, Re, Gll^Gvs, Gll^Gvs, Gs, Hh, Wwg, Hh, Mm, Mm, Mm, Hh, Gs^Fp, Gs, Re, Re, Gs, Gs, Wog, Wog, Wog, Wwg, Gs^Gvs, Re, Gll^Fp, Hh^Fp, Hh, Mm, Mm, Hh, Gll^Fp, Gll^Fp, Gll, Gll, Gll, Mm
Hh^Fp, Hh^Fp, Hh^Fp, Hh, Gs, Hh, Re, Re, Re, Gs^Vc, Gll^Gvs, Wwg, Hh, Hh, Hh, Mm, Mm, Ch, Ch, Ch, Re, Ch, Ch, Ch, Wog, Wog, Wwg, Gs, Gs^Gvs, Gs^Vc, Re, Hh, Hh^Fp, Mm, Hh, Gll^Fp, Gll^Fp, Gs, Wwg, Wwg, Wwg, Wwg
Hh, Hh^Fp, Gll^Gvs, Gs, Gs^Vc, Gs, Re, Gs, Gs, Gll^Gvs, Gs, Wwg, Wwg, Hh, Hh, Gll^Fp, Gll^Fp, Gll^Fp, Gs, Re, Gs, Wwg, Wwg, Wwg, Wwg, Wog, Wog, Gs, Gs, Gs^Gvs, Gll, Re^Fp, Re, Hh, Hh, Gll^Fp, Gs, Wwg, Gs, Gs, Gll, Gll
Hh, Hh, Gll^Gvs, Gll^Gvs, Gll^Gvs, Re, Gs, Re, Re, Re, Re, Gs, Gs, Wwg, Hh, Gll^Fp, Gs, Gll^Fp, Gll, Re, Re, Gll, Gs, Gs, Gs, Wog, Wog, Wog, Wog, Gs, Gs, Gll^Fp, Re, Hh, Gll^Fp, Gs, Gs, Wwg, Gs^Fp, Gs, Gll^Fp, Gll
Hh, Hh, Hh, Gll^Gvs, Gll^Gvs, Gs, Gs, Gll^Gvs, Gll^Gvs, Gs, Gs^Vc, Re, Gs, Wwg, Wwg, Gs, Gs, Gll, Gll^Edt, Gll^Edt, Gs, Re, Gll, Gll, Gll^Edt, Gs, Gs, Wog, Wog, Wwg, Re, Re, Gs^Gvs, Gs^Vc, Re, Gs, Wwg, Wwg, Gs^Fp, Gll^Fp, Hh, Hh
Hh, Hh, Hh, Gs, Hh, Hh, Gll^Gvs, Gll^Gvs, Wwf, Gs, Gs, Re, Gs, Gs, Wwg, Gs, Gs, Gs, Gs, Gs, Wwg, Re, Gs, Gll^Edt, Gll^Vhr, Gs, Gll, Wwg, Wog^Bp/, Wog^Bp/, Wog, Gs, Gs, Gll^Gvs, Gs, Wwf, Gs, Gs^Fp, Gll^Fp, Gll^Fp, Hh, Hh
Mm, Mm, Mm, Mm, Hh, Gs, Gs, Wwf, Gs, Wwf, Wwf, Wwf^Bp|, Wwf, Wwf, Gs, Wwg, Wwg, Wwg, Wwg, Wwg, Ce, Wwg^Bp|, Wwg, Gs, Gs, Gll^Edt, Gll^Edt, Gs, Gs, Wog, Wog, Wog, Wog, Gs, Wwg, Wwg, Gs, Gll^Fp, Hh^Fp, Hh^Fp, Mm, Mm
Mm, Mm, Hh, Mm, Hh, Gll^Fp, Wwf, Wwf, Gll^Fp, Gs, Gs, Re, Gs, Gs, Hh, Gs, Gs, Ce, Gll, Gs, Gs, Re, Wwg, Ce, Wwg, Gs, Wwg, Gll, Gs, Gs, Wog, Wog, Wog, Wog, Wwg, Gs, Gll^Vc, Gll^Em, Hh^Fp, Hh^Fp, Mm, Mm
Mm, Mm, Hh, Hh, Hh, Hh, Hh, Gll^Fp, Gll^Fp, Gs, Gs, Re, Re, Gs, Hh, Hh, Re, Gll, Re, Gll, Re, Re, Gs, Wwg, Gs, Wwg, Gs, Wwg, Wwg, Wwg, Wwg, Wog, Wwg, Wog, Wog, Gs, Gs, Hh, 4 Hh, Mm, Mm, Mm
Mm, Hh, Mm, Hh, Hh, Hh, Hh^Fp, Gs^Fms, Hh^Fp, Gs^Fms, Hh^Fp, Gs^Fms, Gs^Fms, Re, Re, Re, Gs, Re, Ce, Re, Re, Gll, Ce, Gs, Gll, Gs, Gs, Gs, Gs, Wwg, Gs, Wog, Wog, Wog, Wwrg^Edt, Wog^Bp/, Gs, Gll, Gll^Fp, Hh, Hh^Fp, Hh^Fp
Mm, Mm, Mm, Mm, Mm, Hh, Hh, Hh^Fp, Mm, Hh^Fp, Gs^Fms, Gs^Fms, Gs^Fms, Gs, Ce, Gs, Re^Vct, Ce, 1 Ke, Ce, Re, Ce, 2 Ke, Ce, Re^Vct, Gll, Ce, Gs, Gs, Gs, Gs^Vhr, Gs, Wog^Bp/, Wwrg^Edt, Wog, Wog, Gs, Gll^Em, Gll, Hh^Fp, Hh^Fp, Hh^Fp
Mm, Mm, Mm, Mm, Mm, Mm, Mm, Mm, Mm, Hh^Fp, Gs^Fms, Gs^Fms, Hh, Gs, Gs, Gs, Gll, Ce, Re^Vct, Ce, Re, Ce, Re^Vct, Ce, Gll, Gll, Re, Gs, Re, Re, Re, Re, Wog, Wwg, Wog, Wog, Wog, Gs, Gll, Gll^Fp, Hh^Fp, Hh^Fp
Mm, Mm, Mm, Mm, Mm, Mm, Mm, Mm, Hh, Gs^Fms, Gs^Fms, Hh^Fp, Gs^Fms, Hh, Gs^Fms, Gs, Gs^Fms, Gs, Gll, Gll, Gs, Re, Re, Gll, Gs, Re, Gs, Re, Gs^Fms, Gs, Gs, Gs, Wog, Wog, Wog, Wog, Wwg, Gs, Gs, Gll^Fp, Gll^Fp, Hh^Fp
Mm, Mm, Mm, Mm, Mm, Mm, Mm, Mm, Hh, Gs^Fms, Hh, Gs^Fms, Hh^Fp, Gs^Fms, Hh^Fms, Hh^Fms, Gs^Fms, Gs^Fms, Hh^Fms, Gs^Fms, Gs^Fms, Gs, Re, Gs, Re, Re, Gs, Gs^Fms, Gs^Fms, Gs^Fms, Gs^Fms, Gs, Gs, Wog, Wog, Wog, Wog, Wwf, Gs, Gll, Gll^Em, Hh^Fp
Mm, Mm, Mm, Mm, Mm, Mm, Mm, Mm, Mm, Hh, Mm, Hh, Mm, Hh, Hh^Fp, Hh^Fms, Hh^Fms, Hh^Fms, Hh^Fms, Gs^Fms, Gs^Fms, Gs, Gs, Re, Gs, Gs, Gs^Fms, Gs^Fms, Gs^Fms, Gs^Fms, Gs^Fms, Gs^Fms, Gs^Fms, Wwf, Wog, Wog, Wog, Wog, Wog, Gs, Gll, Gll
Mm, Mm, Gs, Mm, Mm, Mm, Mm, Mm, Gs, Mm, Mm, Mm, Mm, Hh, Hh, Hh^Fms, Gs, Hh^Fms, Hh, Gs^Fms, Gs, Gs, Gs, Re, Gs, Gs, Gs, Gs^Fms, Gs, Gs^Fms, Gs, Gs^Fms, Gs^Fms, Gs^Fms, Wog, Wog, Gs, Wog, Wog, Gs, Gs, Gll
