Hh, Hh, Hh, Hh, Hh, Hh, Hh, Mm, Mm, Mm, Mm, Mm, Mm, Mm, Mm, Mm, Mm^Xm, Mm, Mm, Mm, Mm, Hh, Hh, Hh, Hh, Mm, Mm, Mm, Mm, Mm, Mm, Hh, Hh, Hh, Re, Hh, Hh, Hh, Hh, Hh, Hh, Hh
Hh, Hh, Hh, Hh, Hh, Hh, Hh, Hh, Mm, Mm, Mm, Mm, Mm, Mm, Mm, Mm, Mm^Xm, Mm, Mm, Mm, Hh, Hh, Hh, Hh, Hh, Hh, Mm, Mm, Mm, Mm, Hh, Hh, Re, Re, Hh, Hh, Hh, Hh, Gs^Es, Hh, Hh, Hh
Hh, Hh, Hh, Hh, Hh, Hh, Mm, Mm, Mm, Mm, Mm, Mm, Mm, Mm, Mm, Mm, Mm, Mm^Xm, Mm, Mm, Mm, Mm, Mm, Hh, Hh, Hh, Hh, Hh, Hh, Hh, Re, Re, Ch, Re, Re, Gs^Es, Gs^Es, Gs^Es, Gs^Es, Hh, Mm, Mm
Mm, Hh, Hh, Hh, Mm, Mm, Mm, Mm, Mm, Mm, Hh, Mm, Mm, Mm, Mm, Mm, Mm^Xm, Mm^Xm, Mm^Xm, Mm, Mm, Mm, Hh, Hh, Hh, Gs^Es, Gs^Es, Hh, Gs^Es, Hh^Vhhr, Re, Ch, 3 Kh, Ch, Re, Gs^Es, Gs^Es, Gs^Es, Hh, Hh, Mm, Mm
Mm, Mm, Hh, Hh, Hh, Mm, Hh, Hh, Hh, Mm, Hh, Mm, Hh, Mm, Mm, Mm, Mm^Xm, Mm^Xm, Mm, Mm, Mm, Mm, Mm, Hh, Mm, Hh, Gs^Es, Gs^Es, Gs^Dr, Gs^Es, Re, Ch, Ch, Ch, Re, Hh, Hh, Hh, Mm, Mm, Mm, Mm
Re, Hh, Gg, Hh, Hh, Hh, Mm, Hh, Mm, Hh, Mm, Hh, Hh, Mm, Mm, Mm^Xm, Mm^Xm, Mm, Mm, Mm, Hh, Mm, Hh, Mm, Mm, Hh, Hh, Gs^Es, Gs^Es, Gs^Es, Re, Re, Re, Re, Gs^Es, Hh, Hh, Hh, Hh, Hh, Hh, Hh
Re, Gg, Gg, Gg, Hh, Hh, Mm, Mm, Mm, Mm, Hh, Hh, Wo, Wo^Dr, Mm, Mm, Mm^Xm, Mm^Xm, Mm, Mm, Hh, Hh, Hh, Hh, Hh, Hh, Re, Re, Re, Re, Gs^Es, Gs^Es, Gs^Es, Gs^Es, Hh, Gs^Es, Hh, Hh, Gs^Es, Gs^Es, Gs^Es, Gs^Es
Gg, Re, Re, Gg, Hh, Mm, Hh, Mm, Hh, Hh, Hh, Hh, Wo, Hh, Mm, Mm^Xm, Mm^Xm, Mm, Mm, Mm, Hh, Hh, Gs^Es, Hh, Gs^Es, Re, Gs^Es, Hh, Hh, Gs^Es, Gs^Es, Gs^Es, Gs^Es, Hh, Hh, Hh, Gs^Es, Gs^Es, Gs^Es, Gs^Dr, Gs^Es, Gs^Es
Gg, Gg, Re, Gg, Gg, Gg, Hh, Hh, Ww, Wo, Wo, Wo, Hh, Mm, Mm, Mm, Mm, Mm^Xm, Mm, Mm, Hh, Gs^Es, Gs^Es, Gs^Vc, Gs^Es, Re, Gs^Es, Hh, Hh, Hh, Gs^Es, Gs^Dr, Gs^Es, Hh, Hh, Hh, Hh, Hh, Hh, Gs^Es, Hh, Gs^Es
Hh, Gg, Re, Gg, Gg, Hh, Ww, Hh, Wo, Wo, Wo, Hh, Hh, Mm, Wo^Dr, Mm, Mm^Xm, Mm^Xm, Mm^Xm, Mm, Hh, Hh, Gs^Es, Gs^Es, Hh, Re, Hh, Gs^Es, Hh, Hh, Hh, Gs^Es, Hh, Gs^Es, Hh, Mm, Mm, Mm, Hh, Hh, Hh, Hh
Hh, Gg, Re, Gg, Gg, Ww, Wo, Wo, Wo, Wo, Wo, Hh, Hh, Hh, Wo, Mm, Mm, Mm, Mm^Xm, Mm^Xm, Mm, Gs^Es, Gs^Es, Gs^Es, Re, Re, Hh, Hh, Hh, Mm, Mm, Mm, Hh, Hh, Hh, Hh, Mm, Mm, Mm, Mm, Hh, Hh
Hh, Gg, Gg, Re, Ww, Ww^Edt, Wo^Edt, Wo, Wo, Ww, Ss, Wo, Wo, Wo, Hhd, Mm, Mm, Mm, Mm^Xm, Mm, Mm, Mm, Gs^Es, Gs^Es, Re, Hh, Hh, Hh, Mm, Mm, Mm^Xm, Mm, Mm, Hh, Mm, Mm, Mm, Mm, Mm, Mm, Mm, Mm
Ss, Hh, Gg, Ss, Wo^Edt, Wwrg^Edt, Wwrg^Edt, Wo^Edt, Ww, Sm, Ss, Ss, Gll^Em, Hhd, Hhd, Hhd, Mm, Mm^Xm, Mm, Mm^Xm, Mm^Xm, Mm^Xm, Mm, Gs^Es, Re, Hh, Hh, Mm, Mm, Mm, Mm^Xm, Mm, Mm, Mm, Mm^Xm, Mm^Xm, Mm, Mm, Mm^Xm, Mm, Mm^Xm, Mm
Gll^Em, Ss, Sm, Wo, Wo, Wo^Edt, Ss, Ww, Rb, Ss, Ss, Ss^Emf, Gll^Em, Hhd, Hh, Mm, Hh, Mm, Mm, Mm, Mm^Xm, Mm, Hh, Re, Hh, Mm, Mm^Xm, Mm^Xm, Mm^Xm, Mm^Xm, Mm^Xm, Mm^Xm, Mm^Xm, Mm^Xm, Mm, Mm^Xm, Mm^Xm, Mm^Xm, Mm, Mm^Xm, Mm^Xm, Mm
Ss, Gll^Em, Wo, Wo, Wo, Ss, Ss, Gll^Em, Gll^Em, Rb, Rb, Gll^Em, Hhd, Hhd, Hh, Hh, Hh, Mm, Mm, Mm^Xm, Mm, Md^Xm, Md^Xm, Re, Md^Xm, Md^Xm, Mm, Mm, Mm, Mm, Mm, Mm, Hh, Mm^Xm, Hh, Mm, Mm, Mm, Hh, Mm, Mm^Xm, Mm
Ss, Ss, Wo, Wo, Sm, Ss, Ss, Ss, Hhd, Gll^Em, Re^Gvs, Rb, Re^Eff, Re^Gvs, Re^Gvs, Hh, Hh, Mm, Hh, Mm, Mm, Md^Xm, Chr, Chr, Chr, Md^Xm, Mm, Hh, Hh, Hh, Hh, Hh, Hh, Hh, Hh, Mm, Hh, Hh, Hh, Mm, Mm, Mm^Xm
Wo, Wo, Wo, Wo, Sm, Sm, Ss, Hhd, Hhd, Gll^Em, Re^Gvs, Rb, Rb, Re^Eff, Re^Eff, Hh, Re^Gvs, Hh, Re^Gvs, Hh, Hh, Rp^Es, Rp^Es, Chr, Rp^Es, Rp^Es, Hh, Hh, Re^Gvs, Hh, Re^Gvs, Hh, Re^Gvs, Hh, Hh, Hh, Hh, Hh, Hh, Mm, Hh, Mm
Ss, Wo, Ss, Sm, Ss, Sm, Ss, Ss, Hhd, Hhd, Re^Gvs, Re^Gvs, Re^Gvs, Rb, Rb, Re^Gvs, Re^Gvs, Re^Gvs, Re^Gvs, Re^Gvs, Re^Gvs, Re^Gvs, Re^Gvs, Rp^Es, Re^Gvs, Re^Gvs, Re^Gvs, Hh, Re^Gvs, Re^Gvs, Re^Gvs, Re^Gvs, Re^Gvs, Re^Gvs, Re^Gvs, Re^Gvs, Re^Gvs, Re^Gvs, Hh, Hh, Hh, Hh
Ss, Ss, Hhd, Ss, Ss, Ss, Ss^Emf, Ss, Gll^Em, Re^Gvs, Re^Gvs, Re^Gvs, Rb, Rb, Re^Gvs, Rb, Rb, Re^Gvs, Re^Gvs, Re^Gvs, Re^Gvs, Re^Gvs, Re^Gvs, Rp, Re^Gvs, Re^Gvs, Re^Gvs, Re^Gvs, Re^Gvs, Re^Gvs, Re^Eff, Re^Gvs, Re^Eff, Re^Gvs, Sm^Edt, Re^Gvs, Re^Gvs, Re^Gvs, Re^Gvs, Hh, Re^Gvs, Hh
Hh, Hhd, Mm, Hhd, Hhd, Ss, Mm, Gll^Em, Re^Eff, Re^Eff, Re^Gvs, Re^Gvs, Rb, Rb^Vh, Re^Gvs, Re^Gvs, Rb, Re^Eff, Re^Eff, Re^Gvs, Re^Eff, Re^Eff, Re, Rp, Re, Re^Eff, Re^Eff, Re^Gvs, Re^Eff, Re^Eff, Rb, Re^Eff, Rb, Rb^Vh, Re^Eff, Re^Gvs, Re^Gvs, Re^Gvs, Re^Gvs, Hh, Re^Gvs, Hh
Mm, Hhd, Mm, Mm, Mm, Mm, Hh, Gll, Hh, Re^Gvs, Re^Gvs, Re^Gvs, Rb, Sm^Edt, Re^Gvs, Re^Gvs, Re^Eff, Rb, Rb, Re^Eff, Rb^Edt, Rb^Edt, Rb^Ecf, Rp, Rb^Ecf, Rb^Edt, Rb^Edt, Re^Eff, Rb, Rb, Re^Gvs, Rb, Re^Gvs, Rb, Rb, Re^Eff, Re^Eff, Re^Gvs, Re^Gvs, Re^Gvs, Hh, Hh
Mm, Mm, Mm, Mm, Mm, Mm, Hh^Fp, Hh, Hh^Fp, Re^Gvs, Re^Gvs, Sm^Edt, Rb^Vh, Rb, Re^Gvs, Re^Gvs, Re^Gvs, Re^Eff, Re^Eff, Rb^Edt, Ce, Ce, Ce, Rp, Ce, Ce, Ce, Rb^Edt, Re^Gvs, Re^Gvs, Re^Gvs, Re^Gvs, Re^Gvs, Re^Gvs, Rb^Vh, Rb, Re^Gvs, Re^Gvs, Re^Gvs, Hh, Hh, Hh
Mm, Mm, Mm, Mm, Hh, Hh^Fp, Mm, Hh^Fp, Hh^Fp, Re^Gvs, Re^Gvs, Re^Gvs, Rb, Rb, Re^Gvs, Re^Gvs, Re^Gvs, Re^Gvs, Re^Eff, Rb^Eff, Rb^Edt, 1 Ke, Rb^Edt, Rp, Rb^Edt, 2 Ke, Rb^Edt, Rb^Edt, Gs^Fms, Re^Gvs, Re^Gvs, Re^Gvs, Rb, Rb, Rb, Sm^Edt, Re^Gvs, Re^Gvs, Re^Gvs, Hh, Re^Gvs, Hh
Mm, Mm, Mm, Mm, Mm, Hh, Mm, Mm, Hh^Fp, Re^Gvs, Re^Gvs, Re^Gvs, Rb, Re^Gvs, Re^Gvs, Re^Gvs, Re^Eff, Re^Eff, Gs^Fds, Gs^Fds, Gs^Fds, Rb^Edt, Gll^Fp, Rp, Gs^Fds, Rb^Edt, Gs^Fds, Gs^Fms, Gs^Fms, Gll^Fp, Re^Gvs, Rb, Re^Gvs, Re^Gvs, Re^Gvs, Re^Gvs, Re^Gvs, Re^Gvs, Re^Gvs, Re^Gvs, Re^Gvs, Hh
Mm, Mm, Mm, Mm, Hh, Mm, Mm, Mm, Hh^Fp, Hh^Fp, Re^Gvs, Re^Gvs, Rb, Rb^Vh, Sm^Edt, Re^Eff, Gll^Fp, Gs^Fds, Gs^Fds, Gs^Fds, Gll^Fp, Gll^Fp, Gll^Fp, Rp, Gs^Fds, Gs^Fds, Gll^Fp, Gll^Fp, Gll^Fp, Re^Gvs, Re^Gvs, Rb, Rb^Vh, Sm^Edt, Re^Gvs, Gll^Fp, Gll^Fp, Re^Gvs, Hh, Re^Gvs, Hh, Hh
Mm, Mm, Mm, Hh, Mm, Hh, Hh^Fp, Mm, Mm, Hh^Fp, Gll^Fp, Gs^Fds, Gs^Fds, Rb, Rb, Gll^Fp, Gll^Fp, Gll^Fp, Gs^Fms, Gs^Fms, Gll^Fp, Gll^Fp, Gll^Fp, Rp, Rp, Gll^Fp, Gll^Fp, Gs^Fms, Gll^Fp, Re^Gvs, Re^Gvs, Rb, Rb, Re^Gvs, Gll^Fp, Gll^Fp, Gll^Fp, Gll^Fp, Hh, Hh, Hh, Hh
Mm, Mm, Mm, Mm, Mm, Hh, Hh, Hh^Fp, Mm, Gll^Fp, Gll^Fp, Gs^Fds, Gll^Fp, Rb, Gll^Fp, Gll^Fp, Gll^Fp, Gll^Fp, Gll^Fp, Gs^Fms, Gll^Fp, Gll^Fp, Gll^Fp, Gll^Fp, Rp, Gll^Fp, Gll^Fp, Gll^Fp, Gll^Fp, Re^Gvs, Re^Gvs, Re^Gvs, Rb, Gll^Fp, Gll^Fp, Gll^Fp, Gll^Fp, Gll^Fp, Gll^Fp, Hh, Hh, Hh
Mm, Mm, Mm, Mm, Hh, Mm, Mm, Hh, Hh, Mm, Hh, Gll^Fp, Hh, Rb, Gll^Fp, Gll^Fp, Gll^Fp, Gll^Fp, Gll^Fp, Gll^Fp, Gll^Fp, Gll^Fp, Gll^Fp, Gll^Fp, Rp, Gll^Fp, Gll^Fp, Gll^Fp, Gll^Fp, Gll^Fp, Gll^Fp, Gll^Fp, Rb, Rb, Re^Gvs, Gll^Fp, Re^Gvs, Gll^Fp, Gll^Fp, Gll^Fp, Hh, Hh
