Gll^Fdf, Gll^Fdf, Gll^Fmf, Gll^Fmf, Gll^Fmf, Gll^Fmf, Gll^Fmf, Gll^Fmf, Gll^Fmf, Gll^Fmf, Gll^Fmf, Wog, Gll^Fdf, Gd, Re, Gd, Hhd^Fdf, Gd, Hhd^Fdf, Hhd, Hhd^Fdf, Gd, Mm, Gd, Mm^Xm, Mm, Mm^Xm, Mm, Mm, Gd, Mm, Mm, Mm, Mm, Mm, Mm, Hhd^Fmf, Hhd^Fmf, Hhd^Fdw, Hhd^Fdw, Hhd^Fmf, Gd^Fdf, Gd^Fdf, Re, Hhd^Fmf, Gll, Hhd^Fdf, Gll, Gd^Efm, Gd, Gd, Gd, Re, Gd, Gll
Gll^Fdf, Gll^Fdf, Gll^Fdf, Gll^Fmf, Gll^Fmf, Gll^Fmf, Gll^Fmf, Gll^Fmf, Gll^Fmf, Gll^Fmf, Gll^Fdf, Gll^Fdf, Gll, Gll, Re, Hhd, Gd^Vc, Gd^Fdf, Hhd^Fdf, Hhd^Fdf, Mm, Mm, Mm, Mm^Xm, Mm^Xm, Mm^Xm, Mm^Xm, Mm^Xm, Mm^Xm, Mm, Mm, Mm, Mm, Mm, Hhd^Fmf, Hhd^Fmf, Hhd^Fmf, Hhd^Fmf, Hhd^Fdw, Hhd^Fmf, Gd^Fdf, Gd^Fdf, Re^Fdw, Gd^Fdf, Re^Fdw, Hhd^Fmf, Hhd^Fdf, Hhd^Fdf, Hhd^Fdw, Gd^Efm, Chr, Re, Gd, Gd, Gll
Gll^Fdf, Gll^Fdf, Gll^Fdf, Gll^Fmf, Gll^Fdf, Gll^Fmf, Gll^Fmf, Gll^Fmf, Gll^Fmf, Gll^Fmf, Gll^Fmf, Gll^Fdf, Gll, Gd, Gd, Re, Gd^Gvs, Hhd^Fdf, Hhd, Hhd^Fdf, Mm, Mm, Mm, Mm, Mm, Mm, Mm, Mm^Xm, Mm^Xm, Mm^Xm, Mm, Mm, Mm, Hhd^Fmf, Hhd^Fdw, Gd^Fdf, Re^Fdw, Gd^Fdf, Gd^Efm, Re^Fdw, Gd^Efm, Re^Fdw, Gd, Gd^Em, Gd, Hhd^Fmf, Gd^Em, Hhd^Fdf, Hhd^Fdw, Gd, Gd, Re, Chr, Gd^Efm, Gll
Gll^Fdf, Gll^Fdf, Gll^Fdf, Gll^Fdf, Gll^Fdf, Gll^Fdf, Gll^Fdf, Gll^Fdf, Gll^Fdf, Gll^Fdf, Gll^Fdf, Gll^Fdf, Gd, Gd, Gd^Vc, Re, Hhd, Hhd, Mm, Mm, Mm, Mm, Mm, Mm, Hhd^Fdf, Mm, Wwf, Mm, Mm, Mm^Xm, Mm, Mm, Hhd^Fdw, Mm, Hhd^Fmf, Hhd^Fdw, Gd^Em, Re^Fdw, Gd^Efm, Gd^Efm, Gd^Edt, Gd, Re^Edt, Re^Vct, Re, Gd, Gd^Efm, Gd^Gvs, Gd^Vhr, Gd^Gvs, Re, Re, Gd, Gd^Efm, Gll
Gll, Gll^Fdf, Gll, Gll^Fdf, Gll, Gll^Fdf, Gll^Fdf, Gll^Fdf, Gll^Fdf, Gll^Fdf, Gll^Fdf, Gll, Gd, Gd^Gvs, Gd^Gvs, Re, Hhd, Hhd^Fdf, Mm^Fdf, Mm^Fdf, Mm, Mm, Hhd^Fdf, Mm, Hhd^Fdf, Mm, Wwf, Mm, Mm, Mm^Xm, Mm, Hhd, Hhd^Fmf, Hhd^Fmf, Hhd^Fmf, Gd^Fdf, Re^Fdw, Gd^Em, Gd, Gd, Re, Re^Edt, Ce, Re, Re, Re^Vct, Gd, Gd^Gvs, Gd^Gvs, Gd^Gvs, Re, Gd, Gd^Fdf, Gd^Em, Gd^Fdf
Wog, Wwg, Wog, Gll, Wwg, Wwg, Wog, Gll, Wwg, Gll^Fdf, Gll, Gll, Gd, Gd^Gvs, Re, Re, Hhd, Gd, Hhd^Fdf, Hhd^Fdf, Hhd, Hhd, Hhd^Fdf, Hhd^Fdf, Wwf, Wwf, Hhd^Fdf, Hhd^Fdf, Mm, Mm, Mm, Mm, Mm, Hhd^Fmf, Gd^Fdw, Gd^Fdf, Gd^Em, Gd, Ce^Ecf, Gd, Re, Ce, 4 Ke, Ce, Re, Re, Gd, Gd, Re^Vct, Re^Vct, Gd, Gd^Em, Gd^Fdf, Gd^Fdf, Gd^Fdf
Wwg, Wog, Wog, Wog, Wog, Wog, Wog, Wog, Wog, Wwg, Wwg, Gd, Ce, Ce, Ce, Re, Gd, Gd^Gvs, Gd^Vc, Gd^Gvs, Gd^Gvs, Hhd^Fdf, Gd^Fdf, Gll^Fdf, Wwf, Hhd^Fdf, Hhd^Fdf, Hhd^Fdf, Mm, Mm, Mm, Wwf, Wwf, Hhd^Fdw, Re, Gd^Fdw, Gd, Gd^Efm, Gd, Gd, Re, Ce, Ce, Ce, Re, Re^Vct, Re, Re, Re, Re^Vct, Gd, Gd, Gd, Gd^Fdf, Gd^Fdf
Gll^Fdf, Gll^Fdf, Gll^Fdf, Wwg, Gll^Fdf, Wwg, Gll, Wwg, Wog, Wog, Wog, Wwg, Ce, 1 Ke, Ce, Re, Re, Re, Gd^Fdf, Hhd, Hhd^Fdf, Hhd, Hhd, Gll^Fdf, Wwf, Hhd^Fdf, Hhd^Fdf, Hhd^Fmf, Mm, Mm, Mm, Mm, Hhd^Fdw, Wwf, Gd^Fdf, Re, Re^Edt, Gd, Ce^Ecf, Gd, Gd, Re, Re, Re, Gd, Re, Re, Ce^Vct, Re, Gd, Re^Vct, Gd, Gd, Gd^Fdf, Gll^Fdf
Gll^Fmf, Gll^Fmf, Gll^Fdf, Gll^Fdf, Gll^Fdf, Gll^Fdf, Gll^Fdf, Gll, Wwg, Wog, Wog, Wwg, Wwg, Ce, Wwg, Gll, Gll, Gll, Gll, Gll^Fdf, Gll^Fdf, Gll^Fdf, Gll^Fdf, Wwg, Wwg, Gll^Fdf, Hhd^Fdf, Hhd^Fdf, Mm, Mm, Hhd^Fmf, Hhd^Fmf, Gd^Fdf, Wwf, Re^Fdw, Gd^Edt, Re^Vhr, Gd^Gvs, Gd^Gvs, Gd, Ce^Ecf, Gd, Gd, Re, Gd^Em, Gd, Gd, Re, Re^Vct, Re, Re, Re, Re^Vct, Gd, Gll
Gll^Fmf, Gll^Fdf, Gll^Fdf, Gll^Fdf, Gd, Gll^Fdf, Ce, Ce, Ce, Wwg, Wog, Wwg, Wwg, Wwg^Bp|, Gll, Wwg, Wwg, Wwg, Wwg, Wwg, Wwg, Wwg, Wwg, Wwg, Gll^Fdf, Gll^Fdf, Hhd^Fdf, Mm, Hhd, Hhd, Hhd, Gd^Fdf, Wwf, Wwf, Gd^Efm, Gd^Gvs, Re^Fdw, Re^Edt, Re, Re, Re, Gd, Re, Re, Gd, Re^Fdf, Re^Fdf, Gd, Re, Re, Ce, Re, Re^Edt, Gd, Gll
Gll^Fmf, Gll^Fdf, Gll^Fdf, Gd^Fdf, Re^Vct, Re, Ce, 2 Ke, Ce, Wwg, Wog, Wwg, Re, Re, Re, Gll, Gd, Gll, Gd, Gll, Gd^Fdf, Gll^Fdf, Gd^Fdf, Gll, Gd^Vc, Gd^Fdf, Re, Gd^Fdf, Gd, Gd^Fdf, Re, Gd, Wwf, Gd, Gd, Gd^Efm, Gd^Efm, Gd, Gd, Re^Fdf, Gd^Gvs, Re, Re^Vhr, Gd^Edt, Gd, Re^Fdf, Re^Fdf, Gd^Em, Re, Ce, 5 Ke, Ce, Re^Edt, Gd^Edt, Gll
Gll^Fmf, Gll^Fmf, Gll^Fdf, Gd, Gd, Re, Re, Ce, Re, Wwg, Wwg^Bp/, Wwg^Bp/, Gll, Gd, Gd, Re, Re, Re, Re, Re, Re, Re, Re, Re, Re, Re, Gd, Re, Re, Re, Wwg^Es, Wwf^Bp\, Re, Gd^Efm, Gd^Vc, Gd^Efm, Gd, Gd, Re, Gd, Re, Re, Gd^Edt, Re^Edt, Re, Ce^Ecf, Gd, Gd, Re, Ce, Ce, Ce, Re, Gd, Gll^Fdf
Gll^Fmf, Gll^Fmf, Gd^Fmf, Gd^Fmf, Gd, Gd^Efm, Gd^Efm, Re, Gd, Re, Wwg, Wwg, Wwg, Gll, Wwg, Wwf, Wwf, Gd, Gd^Fdf, Gd, Gd, Gd, Gll, Gd, Wwg^Es, Wwg, Wwg, Gd, Gd, Wwg^Es, Ko, Wwg^Es, Wwf, Re, Re, Re, Re, Re, Gd^Edt, Re, Gd^Edt, Gd^Gvs, Gd^Gvs, Gd^Gvs, Re, Gd, Ce^Ecf, Gd, Gd, Re, Re, Re, Gd^Em, Gll^Fdf, Gll^Fdf
Gd^Fmf, Gll^Fmf, Gd^Fmf, Gd^Fdf, Gd^Fdf, Gd^Efm, Gd, Re, Gd, Gll, Gll, Wog, Wwg, Wwg, Gll, Re, Gll, Wwg, Gll^Fdf, Gll^Fdf, Wwg, Wwf, Wwf, Wwf, Ch, Kh, Ch, Wwf, Wwg^Es, Wwg^Es, Ce^Bp/, Ko, Ko, Wwf^Es, Ior, Re, Gd, Gd^Gvs, Gd, Gd^Edt, Rd^Edt, Gd^Wm, Rd^Edt, Gd^Gvs, Gd^Edt, Re, Gd, Gd, Ce^Ecf, Gd, Gd, Gd, Gll^Fdf, Gll^Fdf, Gll^Fdf
Gll, Gd^Fmf, Gd, Gd^Fdf, Rb^Gvs, Rb^Gvs, Re, Re, Gd^Wm, Gd^Fdf, Gd^Fdf, Wwg, Wwg, Wwg, Gd, Re, Gll^Fdf, Wwg, Wwg, Wwg, Kh, Wwf, Ch, Ch, Ias, Ias, Rr^Vhh, Ch, Kh, Ce^Bp/, Ias, Ias, Ias, Ior, Ko, Wwf, Wwg, Gd, Gd, Gd^Efm, Gd, Rd, Gd^Efm, Gd, Re^Vhr, Re^Edt, Re, Gd, Re, Gd, Re, Gd, Gd^Gvs, Gll^Fdf, Gll^Fdf
Gll, Gll, Gd, Rb^Gvs, Rb^Gvs, Gd^Vc, Rb^Gvs, Re, Re, Gd^Fdf, Gll^Fdf, Wwg, Wwg, Wwg, Gd^Fdf, Re^Vhs, Gll^Fdf, Gll^Fdf, Wwg, Kh, Kh, Kh, Ias, Ias, Rr^Vhh, Ias, Ias, Ias, Rr^Vhh, Kh, Ias, Ias, Ias, Ias, Ce^Bp/, Ko, Ko, Wwg, Gd^Gvs, Gd^Gvs, Gd^Efm, Gd, Re, Re, Gd^Efm, Gd^Gvs, Gd^Gvs, Re, Gd, Re, Gd^Gvs, Re^Vhr, Gd^Gvs, Gd^Gvs, Gll^Fdf
Gd^Fmf, Gll, Gd^Fdf, Rb^Gvs, Rb^Gvs, Rb^Gvs, Gd, Re, Rb^Gvs, Gd, Rb^Gvs, Wwg, Wwg, Wwg, Wwg^Bp/, Gd, Wwg, Wwg, Ch, Kh, Ias, Ias, Kh^Vhc, Ias, Ias, Ias, Ias, Ias, Ias, Ias, Rr^Vhh, Kh, Kh, Ce^Bp/, Wwf^Es, Wwg^Es, Wwg^Es, Wwg, Gd, Gd^Gvs, Gd, Gd^Efm, Re, Gd^Gvs, Gd, Gd^Gvs, Gd, Gd^Efm, Gd^Efm, Re, Gd, Gd^Gvs, Gd^Gvs, Gd^Gvs, Gd
Gd^Fmf, Gd^Fmf, Hhd^Fdf, Hhd^Fdf, Hhd, Gd^Efm, Re, Re, Rb^Gvs, Rb^Gvs, Rb^Gvs, Gll, Wwg, Wog, Wwg, Wwg, Ch, Ch, Ias, Ias, Ias^Vhh, Ias, Ias, Ias, Kh, Kh, Kh, Ias, Ias, Ias, Ias, Ias, Rr^Vhh, Ch, Ch, Wwg^Es, Wwg, Gd, Wwf, Gd, Re, Re, Gd^Fdf, Gd, Gd^Fdf, Gd, Gd^Fdf, Gd^Efm, Gd, Re, Gd, Gd, Gd^Efm, Gd, Gd
Gd^Fmf, Gd^Fmf, Gd^Efm, Hhd, Rb^Gvs, Gd, Re, Rb^Gvs, Rb^Gvs, Gd^Vc, Rb^Gvs, Gd^Fdf, Wwg, Wog, Wwg, Kh, Ch, Rr^Vhh, Ias, Ias, Ias, Ias, Rr^Vhh, Kh, Kh, 3 Kh, Kh, Kh, Ias, Ias, Rr^Vhh, Ias, Ias, Ias, Ch, Kh, Wwg, Wwf, Re, Wwf^Bp/, Gd, Gd^Fdf, Gd^Fdf, Gd^Fdf, Gd^Fdf, Gd^Fdf, Gd^Fdf, Gd^Fdf, Re, Re, Gd^Fdf, Gd, Gd^Fdf, Gd, Gd^Fdf
Gll, Gll, Gd, Rb^Gvs, Rb^Gvs, Rb^Gvs, Rb^Gvs, Re, Gd, Rb^Gvs, Gd^Fdf, Gd^Fdf, Wwg, Wwg, Wog, Gd^Fmf, Gd^Fmf, Ch, Ch, Rr^Vhh, Ias, Ias, Ias, Ias, Rr^Vhh, Kh, Ias, Ias, Kh^Vhc, Ias, Ias, Ias, Ch, Ch, Wwg, Wwg, Gd^Gvs, Gd^Gvs, Re, Wwf, Wwf, Gd^Fdf, Wwf, Wwf, Wwf, Wwf, Wwf, Re, Gd^Fdf, Gd^Fdf, Gd^Fdf, Gd^Fdf, Gd^Fdf, Gd^Fdf, Gd^Fdf
Hhd^Fmf, Gll, Hhd^Fmf, Rb^Gvs, Rb^Gvs, Rb^Gvs, Re, Re, Re, Gd^Fmf, Rb^Gvs, Rb^Gvs, Rb^Gvs, Wwg, Wwg, Wog, Wwg, Gd^Fmf, Gd^Fmf, Ch, Ias, Ias, Ch, Ias, Ias, Ias, Ias^Vhh, Ias, Ias, Ias, Kh, Kh, Wwg, Wwg, Gd^Gvs, Gd, Re, Re, Gd^Vhr, Gd, Gd^Fdf, Wwf, Gd^Fdf, Gd^Fdf, Gd^Fdf, Gd^Fdf, Re, Wwf, Wwf, Gd, Gd, Gd^Fdf, Hhd^Fmf, Gd^Fdf, Gd
Hhd, Hhd^Fmf, Hhd^Fmf, Gd^Fmf, Gd^Fmf, Gd^Vc, Gd^Efm, Gd, Re, Rb^Gvs, Rb^Gvs, Rb^Gvs, Gd^Fmf, Gll^Fmf, Gll^Fmf, Wog, Wog, Wwg, Wwg, Gd^Fmf, Gd^Fmf, Kh, Kh, Ch, Ch, Ias, Ias, Ias, Ch, Kh, Kh, Kh, Wwg, Gd, Re, Re^Fmf, Hhd^Fmf, Hhd^Fmf, Hhd^Fmf, Hhd^Fmf, Hhd^Fmf, Gd^Fdf, Hhd^Fmf, Gd^Fdf, Hhd^Fmf, Re, Hhd^Fmf, Hhd^Fmf, Wwf, Hhd^Fmf, Hhd^Vhhr, Hhd^Fmf, Hhd^Fmf, Gd^Fdf, Hhd^Fmf
Gd^Fmf, Hhd^Fmf, Hhd, Hhd, Gd, Gd, Gd^Efm, Gd^Wm, Re, Rb^Gvs, Re, Gll^Vc, Gd^Fmf, Gd^Fmf, Gll^Fmf, Wwg, Wwg, Wwg, Wwg, Gd^Fmf, Gd^Fmf, Gll, Gll, Kh, Ias, Ias, Ch, Ch, Wwg, Wwg, Wwg, Wwg, Gd, Gd^Gvs, Re, Hhd^Fmf, Md, Hhd^Fmf, Md, Md, Md, Md, Mm^Xm, Hhd^Fmf, Md, Md^Vhh, Md, Hhd^Fmf, Wwf, Hhd^Fmf, Hhd^Fmf, Hhd, Hhd, Hhd^Fmf, Hhd
Gd^Fmf, Gd^Fmf, Gd^Fmf, Gll, Rb^Gvs, Rb^Gvs, Rb^Gvs, Gd, Re, Re, Wwf^Bp\, Wwf, Wwg, Wwg, Wwg, Wwg, Hhd^Fmf, Wwg, Wwg, Wwg, Wwg, Gd^Fmf, Gd^Fp, Gll, Ch, Ch, Wwg, Wwg, Gd, Gd^Gvs, Gd^Gvs, Gd^Gvs, Re, Re, Hhd^Fmf, Md, Md, Md, Md, Mm, Md, Mm^Xm, Mm^Xm, Mm^Xm, Mm^Xm, Md, Mm^Xm, Md, Md, Wwf, Md, Md, Md, Hhd, Hhd
Ss, Gd^Fmf, Gd^Fmf, Rb^Gvs, Rb^Gvs, Rb^Gvs, Rb^Gvs, Rb^Gvs, Re, Gd, Wwg, Re, Re, Gll, Hhd, Hhd^Fmf, Hhd, Hhd, Wwg, Wwg, Wwg, Gd^Fmf, Gd^Fmf, Kh, Wwg, Wwg, Gll, Gd^Gvs, Re, Re, Re, Re, Gd^Gvs, Hhd^Fmf, Gd^Fmf, Hhd^Fmf, Hhd^Fmf, Wwf, Hhd^Fmf, Md, Hhd^Fmf, Md, Md, Mm^Xm, Mm^Xm, Mm^Xm, Mm^Xm, Mm^Xm, Mm^Xm, Md, Mm^Xm, Md, Md, Md, Mm
Ss, Ss, Gd^Fmf, Rb^Gvs, Gd^Vc, Rb^Gvs, Re, Re, Gd^Fmf, Wwg, Gll, Gd, Gd^Fmf, Re, Rb^Gvs, Rb^Gvs, Rb^Gvs, Hhd^Fmf, Hhd, Wwg, Wwg, Wwg, Wwg, Wwg, Wwg, Gll, Gd^Fmf, Gd^Fmf, Re, Gd^Fmf, Gd, Gd^Vhr, Gd^Gvs, Gd, Gd^Fmf, Gd^Fmf, Wwf, Wwf, Gd^Fmf, Hhd^Fmf, Hhd^Fmf, Md, Md, Mm^Xm, Mm^Xm, Mm^Xm, Mm^Xm, Mm^Xm, Mm^Xm, Mm^Xm, Mm^Xm, Mm^Xm, Mm^Xm, Md, Md
Ss, Ss, Ss, Gd^Fmf, Gll, Re, Gll, Gd^Fmf, Gd^Fmf, Wwg, Gd^Efm, Hhd, Hhd^Fmf, Re, Gd^Vc, Rb^Gvs, Rb^Gvs, Gd^Fmf, Hhd^Fmf, Wwg, Wwg, Wwg, Wog, Wog, Wwg, Gll, Gll, Gd^Fmf, Re, Gd, Gll, Gd^Gvs, Gll, Gd^Fmf, Gll, Wwf^Bp\, Gd, Gd^Vhr, Gd^Gvs, Gd^Fmf, Hhd^Fmf, Md, Md, Md, Md, Md, Md, Md, Wwf, Md, Mm^Xm, Mm^Xm, Mm^Xm, Md, Md
Ss, Wwg, Wwg, Ss, Wwf, Re, Wwg, Gd^Fmf, Wwg, Wwg, Gd^Efm, Gd^Fmf, Re^Fmf, Re, Re, Rb^Gvs, Rb^Gvs, Rb^Gvs, Gd^Fmf, Gd^Fmf, Gll, Wwg, Wwg, Wwg, Wog, Wwg, Wog, Wwg, Wwg^Bp|, Wwg, Wwg, Wwg, Wwg, Wwg, Wwg, Wwf, Gll, Gd^Gvs, Gd^Gvs, Gd^Fmf, Hhd^Fmf, Md, Md, Md, Md, Md, Md, Wwf, Md, Md, Md, Mm^Xm, Mm^Xm, Mm^Xm, Mm^Xm
Ss, Ss, Ss, Wwg, Ss, Wwf, Re, Wwg, Gd^Fmf, Gd^Efm, Re, Re, Hhd^Fmf, Hhd^Fmf, Re, Rb^Gvs, Rb^Gvs, Rb^Gvs, Gd^Fmf, Hhd^Fmf, Hhd^Fmf, Gd, Gd, Gll, Gd^Efm, Wwg, Wwg, Wwg, Re, Wwg, Wwg, Wwg, Wwg, Wwg, Wwg, Wwg, Wwg, Gll, Gll, Gd, Hhd^Fmf, Md, Md, Md, Md, Md^Vhhr, Hhd^Fmf, Wwf, Wwf, Md, Md, Mm^Xm, Mm^Xm, Mm^Xm, Mm^Xm
Ss, Ss, Gll^Fmf, Gll^Fmf, Gll^Fmf, Re, Gd, Gd^Fmf, Hhd^Fmf, Re, Gd^Vc, Rb^Gvs, Rb^Gvs, Hhd^Wm, Gd^Efm, Re, Re, Gd^Efm, Rb^Gvs, Rb^Gvs, Rb^Gvs, Gd^Fmf, Re, Gd^Efm, Rb^Gvs, Gd^Efm, Gd, Gd, Re, Gd, Gd, Gll, Gd, Gd, Gll, Wwg, Wwg, Wwg, Gll, Gd^Fmf, Gd, Hhd^Fmf, Hhd^Fmf, Hhd^Fmf, Hhd^Fmf, Hhd^Fmf, Hhd^Fmf, Hhd^Fmf, Wwf, Md, Md, Md, Md, Mm^Xm, Mm^Xm
Ss, Gll^Fmf, Gll^Fmf, Rb^Gvs, Rb^Gvs, Re, Re, Gd^Fmf, Gd^Fmf, Re^Fmf, Gd^Efm, Rb^Gvs, Rb^Gvs, Rb^Gvs, Gd^Fmf, Gd^Efm, Re, Rb^Gvs, Rb^Gvs, Rb^Gvs, Rb^Gvs, Re, Rb^Gvs, Gd^Vhr, Rb^Gvs, Rb^Gvs, Rb^Gvs, Gd^Efm, Re, Gd^Fdf, Gd^Fdf, Gd^Fdf, Rb^Gvs, Gd^Efm, Gd^Efm, Gll, Wwg, Wwg, Gll, Gd, Gd, Gd^Fmf, Gd, Hhd^Fmf, Hhd^Fmf, Hhd^Fmf, Gd^Fmf, Hhd^Fmf, Wwf, Md, Md, Md, Md, Mm^Xm, Mm^Xm
Ss, Gll^Fmf, Rb^Gvs, Rb^Gvs, Rb^Gvs, Rb^Gvs, Gd^Vc, Re, Re, Re, Gd, Rb^Gvs, Rb^Gvs, Rb^Gvs, Hhd^Fmf, Gd^Fmf, Re, Gd^Vc, Rb^Gvs, Rb^Gvs, Hhd^Fmf, Re, Rb^Gvs, Rb^Gvs, Rb^Gvs, Rb^Gvs, Re, Re, Hhd, Gd^Fmf, Hhd^Fmf, Rb^Gvs, Rb^Gvs, Rb^Gvs, Rb^Gvs, Gd, Wwg, Wwg, Wwg, Gll, Gll, Gd, Gll, Gd^Fmf, Gd^Fmf, Gd^Fmf, Gll, Gd^Fmf, Wwf, Md, Md, Md, Md, Mm^Xm, Mm^Xm
Ss, Gll^Fmf, Rb^Gvs, Rb^Gvs, Rb^Gvs, Rb, Re, Re, Rb^Gvs, Rb^Gvs, Rb^Gvs, Hhd, Gd^Fmf, Gd^Fmf, Hhd^Fmf, Hhd^Fmf, Gd^Fmf, Re, Re, Re, Re^Fmf, Re^Fmf, Re, Rb^Gvs, Gd^Fmf, Gd^Efm, Re, Gd^Wm, Hhd, Hhd^Fmf, Hhd, Rb^Gvs, Gd^Vhr, Rb^Gvs, Rb^Gvs, Gd^Efm, Gll, Wwg, Wwg, Wwg, Wwg, Gll, Wwg, Gll, Wwg, Wwg, Wwf, Wwf, Md, Md, Md, Md, Md, Mm^Xm, Mm^Xm
Ss, Gll^Fmf, Gll^Fmf, Rb^Gvs, Gll^Fmf, Gd^Efm, Re, Rb^Gvs, Rb^Gvs, Rb^Gvs, Rb^Gvs, Hhd, Hhd^Es, Hhd, Re, Gd^Efm, Gd^Efm, Gd, Rb^Gvs, Rb^Gvs, Rb^Gvs, Re, Re, Re, Re, Re, Rb^Gvs, Re, Re, Gd, Re, Gd, Re, Rb^Gvs, Gd^Efm, Gd^Efm, Hhd^Fmf, Gll, Gd, Wwg, Wwg, Wwg, Wwg, Wwg, Wog, Wwg, Md, Md, Md, Md, Md, Mm^Xm, Mm^Xm, Mm^Xm, Mm^Xm
Ss, Ss, Gll^Fmf, Gll^Fmf, Gll^Fmf, Gd, Re, Rb^Gvs, Rb^Gvs, Rb^Gvs, Rb^Gvs, Hhd^Wm, Re^Es, Re, Rb^Gvs, Re, Re, Rb^Gvs, Rb^Gvs, Rb^Gvs, Rb^Gvs, Rb^Gvs, Re, Gd, Gd^Efm, Rb^Gvs, Gd^Vhr, Gll^Fmf, Re, Re, Gd^Fmf, Re, Hhd^Fmf, Re, Re, Hhd, Hhd^Fmf, Hhd^Fmf, Gd^Efm, Gd, Re, Gll, Gll, Wwg^Bp/, Wwg, Wwg, Wwg, Md, Md, Md, Mm^Xm, Mm^Xm, Mm^Xm, Mm^Xm, Mm^Xm
Ss, Ss, Ss, Gll^Fmf, Re, Re, Re, Gd^Efm, Gd^Vc, Rb^Gvs, Hhd^Fmf, Hhd, Re, Rb^Gvs, Rb^Gvs, Rb^Gvs, Rb^Gvs, Re, Ce, Ce, Ce, Rb^Gvs, Re, Re, Re, Rb^Gvs, Rb^Gvs, Gd, Re, Gd^Fmf, Gd^Fmf, Hhd^Fmf, Hhd^Fmf, Hhd^Fmf, Rb^Gvs, Re, Re, Gd^Efm, Re, Re, Gd^Vhr, Gd^Efm, Rb^Gvs, Gd, Hhd^Fmf, Wwg, Wwg, Md, Md, Md, Md, Mm^Xm, Mm^Xm, Mm^Xm, Mm^Xm
Ss, Ss, Ss, Gll^Fmf, Gll^Fmf, Gll^Fmf, Gll^Fmf, Re, Gll^Fmf, Gd^Fmf, Gd^Fmf, Hhd^Fmf, Re, Rb^Gvs, Gd^Vc, Rb^Gvs, Rb^Gvs, Rb^Gvs, Ce, 6 Ke, Ce, Re, Gd^Efm, Gd^Efm, Gd^Efm, Re, Re, Re, Gd^Fmf, Gd^Fmf, Hhd^Fmf, Hhd^Fmf, Hhd^Fmf, Rb^Gvs, Rb^Gvs, Gd^Vhr, Rb^Gvs, Re, Hhd, Rb^Gvs, Rb^Gvs, Rb^Gvs, Rb^Gvs, Hhd^Fmf, Hhd^Fmf, Hhd, Wwg, Md, Md, Md, Md, Mm^Xm, Md, Mm^Xm, Md
Ss, Ss, Ss, Ss, Ss, Ss, Gll^Fmf, Gll^Fmf, Gll^Fmf, Gll^Fmf, Gd^Fmf, Hhd^Fmf, Gd^Fmf, Re, Gd^Fmf, Gd^Fmf, Gd^Fmf, Gd^Fmf, Gd^Fmf, Ce, Gd^Fmf, Gd^Fmf, Gd^Fmf, Gd^Fmf, Gd^Fmf, Gd^Fmf, Gd^Fmf, Gd^Fmf, Gd^Fmf, Gd^Fmf, Hhd^Fmf, Hhd^Fmf, Hhd^Fmf, Rb^Gvs, Rb^Gvs, Rb^Gvs, Rb^Gvs, Rb^Gvs, Hhd, Rb^Gvs, Rb^Gvs, Rb^Gvs, Hhd, Hhd^Fmf, Hhd, Hhd, Wwg, Md, Md, Md, Md, Md, Md, Md, Md
Ss, Ss, Gd, Gll^Fmf, Gll, Gll^Fmf, Gll^Fmf, Gll^Fmf, Gll^Fmf, Gll^Fmf, Gd, Gd^Fmf, Gd^Fmf, Gd^Fmf, Gd^Fmf, Gd^Fmf, Gd^Fmf, Gd^Fmf, Gd^Fmf, Gd^Fmf, Gd, Gd^Fmf, Gd, Gd^Fmf, Gll, Gd^Fmf, Gd^Fmf, Gd^Fmf, Gd^Fmf, Gd^Fmf, Gll, Hhd^Fmf, Gd, Hhd, Gll, Rb^Gvs, Gll, Hhd, Gll, Hhd, Gd, Hhd, Gll, Hhd, Gd, Hhd, Gll, Wwg, Wwg, Md, Md, Md, Md, Md, Md
