Gll^Fmf, Gll, Gll^Fdf, Gll, Gll^Fmf, Gll^Fdf, Gll^Fmf, Gll^Fmf, Gll^Fmf, Gll^Fdf, Wog, Wog, Wwg, Gll, Re, Re, Re, Gll, Gll^Fdf, Gll^Fdf, Gll^Fdf, Mm, Mm, Mm^Xm, Mm, Mm^Xm, Mm, Gll^Fdf, Gll^Fdf, Gll^Fdf, Gll^Fdf, Gll^Fdf, Gll^Fdf, Re, Gll^Fdf, Gll, Gll^Fdf, Gll, Gll, Gll, Gll, Gd, Gll, Re, Gll, Gll, Gll, Gll, Gll, Gll, Gll, Gll, Gll, Gll, Gll
Gll^Fmf, Gll^Fdf, Gll^Fdf, Gll^Fdf, Gll^Fmf, Gll^Fmf, Gll^Fmf, Gll^Fmf, Gll^Fdf, Gll^Fdf, Wog, Wog, Gll, Gll, Re, Re, Gll, Gll, Gll^Fdf, Gll^Fdf, Gll^Fdf, Mm, Mm, Mm^Xm, Mm^Xm, Mm, Mm, Mm, Gll^Fdf, Gll^Fdf, Gll^Fdf, Gll^Fdf, Gll^Fdf, Gll^Fdf, Gll, Gll^Fdf, Gll, Gll, Gll, Gll^Fdf, Gll^Fdf, Gll, Gll, Re, Gll, Gll, Gll, Gll, Gll, Gll, Gll, Gll, Gll, Gll, Gll
Gll^Fmf, Gll^Fmf, Gll^Fmf, Gll^Fmf, Gll^Fmf, Gll^Fmf, Gll^Fdf, Gll^Fdf, Gll^Fdf, Wwg, Wog, Wog, Gll, Re, Re, Gs^Vc, Gll, Gll^Fdf, Gll^Fdf, Gll^Fdf, Hhd^Fdf, Hhd^Fdf, Mm, Mm^Xm, Mm^Xm, Mm^Xm, Mm, Mm, Mm, Hhd, Gll^Fdf, Gll^Fdf, Gll^Fdf, Gll, Gll, Gll, Gll, Gll, Gll^Fdf, Gll^Fdf, Gll^Fdf, Gll, Re, Re, Gll, Gll, Gll, Gll, Gll, Gll, Gll, Gll, Gll, Gll, Gll
Gll^Fmf, Gll^Fmf, Gll, Gll, Gll, Gll^Fmf, Gll^Fdf, Gll^Fdf, Gll^Fdf, Wog, Wog, Gll, Re, Re, Gll^Fdf, Gll, Gll, Gll^Fdf, Gll^Fdf, Hhd^Fdf, Hhd, Mm, Mm, Mm, Mm, Mm^Xm, Mm, Mm, Mm, Hhd^Fdf, Gll^Fdf, Gll^Fdf, Gll^Fdf, Gll^Fdf, Gd^Vhr, Re, Re, Gll, Gll, Gll^Fdf, Gll, Gll, Re, Re^Vct, Gll^Ecf, Gll, Gll, Gll, Gll, Gll, Gll, Gll, Gll, Gll, Gll
Re, Re, Re, Re, Re, Gll^Fdf, Gll^Fdf, Gll^Fdf, Wwg, Wog, Wog, Gll, Re, Gll^Fdf, Gll^Fdf, Gll, Gll, Gll^Fdf, Hhd, Hhd, Mm, Mm, Mm, Mm, Mm, Mm, Mm, Mm, Mm, Mm, Hhd, Hhd, Gll^Fdf, Gll^Fdf, Gll^Fdf, Gll^Fdf, Re, Gll, Re, Gll, Re, Re, Ce, Re, Re, Re^Vct, Gll, Gll^Fdf, Gll, Gll, Gll, Gll, Gll, Gll, Gll
Gll, Gll, Gll, Gll, Gll, Re, Gll^Fdf, Gll^Fdf, Gll^Fdf, Wog, Wog, Gll, Gll, Re, Re, Gll, Gll, Gll, Gll^Fdf, Gll^Fdf, Hhd^Fdf, Mm, Mm, Mm, Wwg, Wwg, Mm, Mm^Xm, Mm, Mm, Hhd, Hhd^Fdf, Gll^Fdf, Gll^Fdf, Gll^Fdf, Gll^Fdf, Gll^Fdf, Re, Gll^Fdf, Re, Gll, Ce, 4 Ke, Ce, Re, Gll^Ecf, Gll, Gll, Gll^Fdf, Gll, Gll, Gll, Gll, Gll, Gll
Gll, Gll^Fmf, Gll, Gll, Gll, Re, Re, Gll^Fdf, Gll^Fdf, Wwg, Wwg, Wwg, Ce, Ce, Ce, Re, Gs^Vc, Gll, Gll, Gll^Fdf, Hhd, Hhd, Mm, Mm, Wwg, Mm, Mm, Mm, Mm, Mm, Mm, Mm, Hhd, Gll^Fdf, Gll^Fdf, Gll^Fdf, Gll^Fdf, Gll, Gll, Gll, Gll, Ce, Ce, Ce, Re, Re^Vct, Gll, Gll^Fdf, Gll^Fdf, Gll, Gll, Gll, Gll, Gll, Gll
Gll^Fmf, Gll^Fmf, Gll^Fmf, Gll^Fmf, Gll^Fmf, Gll, Gll, Re, Gll, Wwg, Wwg, Wwg, Ce, 1 Ke, Ce, Re, Gll, Gll, Gll^Fdf, Gll, Gll^Fdf, Gll^Fdf, Hhd, Gll^Fdf, Wwg, Hhd, Mm, Mm, Mm, Mm, Mm, Mm, Hhd^Fdf, Gll^Fdf, Gll^Fdf, Gll^Fdf, Gll, Gll, Gll, Gll, Gll, Gll, Re, Re, Re, Gll, Gll^Fdf, Gll, Gll, Gll, Re^Vct, Gll, Gll, Gll, Gll
Gll^Fdw, Gll^Fmf, Gll^Fmf, Gll^Fmf, Gll^Fmf, Gll, Re, Re, Gll, Gll, Wwf, Wwg, Wwg, Ce, Wwg, Re, Gll, Gll, Gll, Gll, Gll^Fdf, Gll^Fdf, Gll^Fdf, Wwg, Wwg, Gll^Fdf, Hhd, Hhd, Mm, Hhd, Mm, Mm, Hhd^Fdf, Hhd, Gll^Fdf, Gll^Fdf, Gll, Gll, Gll^Fdf, Gll, Re, Re, Rb^Gvs, Re, Rb^Gvs, Re, Re, Gll, Re^Vct, Gll^Ecf, Gll, Gll^Ecf, Re^Vct, Gll, Gll
Gll^Fdw, Gll^Fdw, Gll^Fdw, Gll^Fmf, Gll, Re, Ce, Ce, Ce, Gll, Wwf, Wwg, Wwg, Wwf^Bw|, Gll, Wwg, Wwg, Wwg, Wwg, Wwg, Wwg, Wwg, Wwg, Wwg, Gll, Gll, Hhd, Gll^Fdf, Hhd, Hhd, Hhd, Hhd, Hhd, Hhd^Fdf, Gll^Fdf, Gll, Rb^Gvs, Gll^Fdf, Re, Re, Gll, Gll^Fdf, Rb^Gvs, Rb^Gvs, Gd^Vhr, Rb^Gvs, Rb^Gvs, Re, Gll, Gll, Ce, Gll, Gll, Gll, Gll
Gll^Fdw, Gll^Fdw, Gll, Gll^Fmf, Re^Vct, Re, Ce, 2 Ke, Ce, Wwf, Wwf, Wwf, Re, Re, Re, Gll, Gll, Gll, Gll^Fdf, Gll, Gll, Gll, Gll^Fdf, Gll, Gll, Gll^Fdf, Hhd, Hhd, Gll^Fdf, Hhd, Gll^Fdf, Gd, Hhd, Hhd, Gll, Rb^Gvs, Rb^Gvs, Gd^Vhr, Re, Gll, Gll, Gll, Gll, Rb^Gvs, Rb^Gvs, Rb^Gvs, Rb^Gvs, Re, Gll, Ce, 5 Ke, Ce, Gll, Gll, Gll
Gll^Fmf, Gll^Fdw, Gll, Gll, Gll, Re, Re, Ce, Gll, Wwf, Wwf^Bw/, Wwf^Bw/, Gll, Gll, Gs^Vc, Re, Re, Gll, Gll^Fdf, Gll^Fdf, Gs^Vc, Rb^Gvs, Re, Re, Re, Hhd, Rb^Gvs, Rb^Gvs, Rb^Gvs, Gll^Fdf, Re, Gll^Fdf, Gll, Gll, Gll, Rb^Gvs, Rb^Gvs, Rb^Gvs, Re, Gll^Fdf, Re, Re, Re, Gll, Gll, Gll, Gll, Re, Re, Ce, Ce, Ce, Re, Gll, Re
Gll^Fmf, Gll^Fmf, Gll^Fmf, Gll^Fmf, Hhd, Gll, Gll, Re, Re, Re, Wwg, Wwg, Wwg, Gll, Gll, Rb^Gvs, Rb^Gvs, Re, Re, Re, Re, Re, Gll, Gll, Re, Re, Re, Re, Re, Re, Hhd^Dr, Re, Re, Re, Re, Re, Re, Re, Gll, Re, Rb^Gvs, Rb^Gvs, Gll^Fdf, Gll^Fdf, Gll^Fdf, Gll, Gll, Gll^Fdf, Gll, Re, Re, Re, Gll, Re, Gll
Gll^Fmf, Gll^Fmf, Gll^Fmf, Hhd, Hhd^Fmf, Gll, Re, Re, Gll^Fmf, Gll, Wwg, Wog, Wwg, Gll, Gll^Fdf, Rb^Gvs, Rb^Gvs, Rb^Gvs, Rb^Gvs, Rb^Gvs, Rb^Gvs, Gll, Gll, Gll, Chr, Khr, Hhd^Dr, Re, Re, Re^Edb, Re, Chr, Chr, Re, Re, Gll, Gll^Fdf, Gll, Rb^Gvs, Rb^Gvs, Rb^Gvs, Rb^Gvs, Re, Gll^Fdf, Gll^Fdf, Gll, Rb^Gvs, Gll, Gll, Gll, Gll, Gll, Gll, Gll, Gll
Gll^Fmf, Gll^Fmf, Gll, Hhd, Rb^Gvs, Rb^Gvs, Re, Gll, Gll^Fdw, Gll^Fmf, Gll^Fmf, Wwg, Wwg, Wwg, Gll^Fdf, Gll^Fdf, Rb^Gvs, Rb^Gvs, Rb^Gvs, Re, Kh, Re, Chr, Chr, Re, Re, Rp^Vhcr, Hhd^Dr, Chr, Re^Edb, Rr, Re, Rr, Rr, Khr, Gll, Gll, Gll, Gll, Rb^Gvs, Rb^Gvs, Gd^Vhr, Rb^Gvs, Re, Re, Rb^Gvs, Rb^Gvs, Rb^Gvs, Rb^Gvs, Gll, Gll, Gll, Gll^Fdf, Gll, Gll
Gll^Fmf, Gll^Fmf, Gll, Rb^Gvs, Rb^Gvs, Gs^Vc, Rb^Gvs, Re, Gll^Fdw, Gll^Fmf, Gll^Fmf, Gll^Fmf, Wwg, Wwg, Gll^Fdf, Gll^Fdf, Re, Re, Re, Kh, Kh, Kh, Rr, Re, Rp^Vhcr, Re, Re, Re, Rp^Vhcr, Chr, Rr, Rr, Rr, Re, Gll, Hhd^Dr, Chr, Gll, Gll, Gll^Fdf, Rb^Gvs, Rb^Gvs, Gll^Fdf, Gll, Re, Rb^Gvs, Rb^Gvs, Rb^Gvs, Rb^Gvs, Gll, Gll, Gll, Gll^Fdf, Gll^Fdf, Gll^Fdf
Gll^Fdw, Gll^Fdw, Gll, Rb^Gvs, Rb^Gvs, Rb^Gvs, Re, Re, Rb^Gvs, Hhd, Rb^Gvs, Gll, Wwg, Wwg, Gll, Gll, Gll, Gll, Ch, Kh, Gll^Fdf, Rr, Kh, Rr, Rr, Rr, Rr, Re, Rr, Rr, Rp^Vhcr, Chr, Chr, Re^Edb, Re, Gll^Edb, Gll^Edb, Gll, Gll, Gll, Gll, Gll, Gll, Gll, Re, Rb^Gvs, Rb^Gvs, Gd^Vhr, Gll^Fdf, Gll^Fdf, Gll, Gll, Gll^Fdf, Gll^Fdf, Gll^Fdf
Gll^Fdw, Gll^Fdw, Gll^Fdw, Gll, Hhd, Gll^Fmf, Re, Gll^Fmf, Rb^Gvs, Rb^Gvs, Rb^Gvs, Gll^Fdw, Wwg, Wog, Wwg, Gll, Ch, Ch, Re, Rr^Vhc, Re, Rr, Rr, Rr, Kh, Khr, Khr, Rr, Rr, Re, Re, Rb^Edb, Rp^Vhcr, Chr, Hhd^Dr, Re^Edb, Re, Gll, Gll, Gll, Gll, Gll, Gll, Gll, Gll, Re, Re, Re, Gll, Gll^Fdf, Gll^Fdf, Gll, Gll, Gll^Fdf, Gll^Fdf
Gll^Fmf, Gll^Fdw, Gll^Fmf, Gll^Fmf, Rb^Gvs, Gll^Fmf, Re, Rb^Gvs, Rb^Gvs, Gs^Vc, Rb^Gvs, Gll^Fmf, Gll, Wog, Wwg, Kh, Ch, Rr^Vhc, Gll, Re, Re, Re, Rr^Vhc, Kh, Kh, 3 Kh, Khr, Khr, Rr, Re, Rp^Vhcr, Re, Re, Re, Chr, Khr, Re, Gll, Hhd, Hhd, Gll^Fdf, Hhd, Hhd, Hhd, Gll, Gll, Gll, Gll, Gll^Fdf, Gll, Gll, Gll, Gll, Gll^Fdf, Gll^Fdf
Gll^Fmf, Gll^Fmf, Gll^Fmf, Rb^Gvs, Rb^Gvs, Rb^Gvs, Rb^Gvs, Re, Re, Rb^Gvs, Hhd^Fmf, Gll, Gll, Wwg, Wog, Wwg, Re, Ch, Ch, Rr^Vhc, Gll^Fdf, Rr, Rr, Rr, Rr^Vhc, Kh, Rr, Rr, Khr, Rr, Re, Re, Hhd, Chr, Re, Re, Gll, Gll^Fdf, Gll^Fdf, Gll^Fdf, Mm, Mm, Mm, Hhd, Hhd, Gll, Gll, Gll^Fdf, Gll^Fdf, Gll^Fdf, Gll^Fdf, Gll, Gll^Fdf, Gll, Gll
Gll^Fdw, Gll, Rb^Gvs, Rb^Gvs, Rb^Gvs, Rb^Gvs, Gll^Fmf, Gll, Re, Hhd^Fmf, Rb^Gvs, Rb^Gvs, Rb^Gvs, Gll^Fdw, Wwg, Wog, Wwg, Gll, Gll, Ch, Re, Gll, Ch, Rr, Rr, Rr, Rr, Rr, Rr, Rr, Khr, Khr, Gll^Edb, Re, Gd^Vhr, Gll, Hhd, Gll^Fdf, Hhd^Fdf, Gll^Fdf, Hhd, Mm, Mm, Mm, Gll^Fdf, Gll^Fdf, Hhd, Hhd, Hhd^Fdf, Hhd, Gll^Fdf, Hhd, Gll^Fdf, Gll^Fdf, Gll^Fdf
Hhd^Fmf, Hhd, Gll, Rb^Gvs, Re, Gs^Vc, Re, Re, Re, Rb^Gvs, Rb^Gvs, Rb^Gvs, Hhd^Fmf, Gll, Gll^Fmf, Wog, Wog, Wwg, Wwg, Gll, Gll, Kh, Kh, Ch, Ch, Rr, Rr, Gll^Fdf, Ch, Kh, Kh, Khr, Gll, Re, Gll, Gll, Hhd^Fdf, Hhd^Fdf, Hhd^Fdf, Gll^Fdf, Mm, Mm, Mm, Mm, Gll^Fdf, Hhd^Fdf, Hhd^Fdf, Hhd, Hhd^Fdf, Hhd^Fdf, Hhd^Fdf, Hhd, Gll^Fdf, Hhd, Hhd
Gll^Fmf, Hhd, Re, Re, Gll^Fmf, Re, Gll, Gll^Fmf, Re, Rb^Gvs, Re, Gs^Vc, Gll^Fmf, Gll^Fmf, Gll^Fmf, Gll^Fdw, Wwg, Wwg, Wwg, Gll, Gll, Gll, Gll, Kh, Rr, Rr, Ch, Ch, Gll, Gll, Gll, Gll, Gll, Re, Gll, Gll, Gll^Fdf, Gll^Fdf, Gll^Fdf, Mm, Mm, Mm, Mm, Mm, Mm, Mm, Mm, Hhd, Gll^Fdf, Hhd^Fdf, Mm, Mm, Gll^Fdf, Mm, Hhd^Fdf
Gll, Gll, Re, Gll^Fmf, Rb^Gvs, Rb^Gvs, Rb^Gvs, Gll, Hhd^Fmf, Re, Wwf^Bw\, Wwf, Wwg, Wwg, Wwg, Wwg, Gll^Fmf, Wwg, Wwg, Wwg, Gll, Gll, Gll, Gll, Ch, Ch, Gll, Gll, Gll^Fdf, Gll^Fdf, Gll^Fdf, Gll, Re, Re, Re, Re, Re, Gll^Fdf, Hhd^Fdf, Hhd, Mm, Mm, Mm, Mm, Mm, Mm, Mm, Hhd^Fdf, Mm, Mm, Hhd^Fdf, Mm, Mm, Hhd^Fdf, Mm
Gll, Gll, Re, Rb^Gvs, Rb^Gvs, Rb^Gvs, Rb^Gvs, Rb^Gvs, Gll^Fmf, Gll^Fmf, Wwg, Re, Re, Gll, Hhd, Hhd^Fmf, Gll^Fmf, Gll^Fmf, Wwg, Wwg, Wwg, Gll, Gll, Kh, Gll^Fdf, Gll, Hhd, Gll, Re, Re, Re, Re, Gll^Fdf, Gll^Fdf, Hhd, Gll^Fdf, Gll^Fdf, Re, Hhd^Fdf, Hhd^Fdf, Mm, Hhd, Mm, Mm, Mm, Mm, Mm, Mm, Mm, Mm, Mm, Mm, Mm, Mm, Mm
Gll^Fdw, Gll^Fdw, Re, Rb^Gvs, Gs^Vc, Rb^Gvs, Gll, Gll, Hhd^Fmf, Wwg, Gll, Hhd, Gll, Re, Rb^Gvs, Rb^Gvs, Rb^Gvs, Gll^Fmf, Gll^Fmf, Wwg, Wwg, Wwg, Gll, Gll^Fdf, Gll^Fdf, Hhd, Hhd^Fdf, Gll, Re, Gll, Gll, Gd^Vhr, Gll, Gll^Fdf, Hhd^Fdf, Hhd^Fdf, Gll^Fdf, Re, Gll^Fdf, Hhd^Fdf, Hhd, Hhd, Mm, Mm, Mm, Mm, Mm, Mm, Mm, Mm, Mm, Mm, Mm, Mm, Mm
Wwg, Gll^Fmf, Hhd^Fmf, Re, Gll, Gll, Gll^Fmf, Hhd, Hhd^Fmf, Wwg, Gll, Gll, Gll^Fmf, Re, Gs^Vc, Rb^Gvs, Rb^Gvs, Gll^Fmf, Gll, Wwg, Wwg, Wwg, Wog, Gll^Fdf, Wwg, Hhd, Hhd^Fdf, Hhd^Fdf, Re, Gll^Fdf, Gll, Gll, Gll, Gll, Gll, Hhd, Gll, Gd^Vhr, Gll, Gll, Gll^Fdf, Gll^Fdf, Hhd, Mm, Mm, Mm, Mm, Mm, Mm, Mm, Mm, Mm, Mm, Mm, Mm
Gll, Wwg, Wwg, Gll^Fmf, Wwf, Gll, Wwg, Gll^Fmf, Wwg, Wwg, Hhd^Fmf, Gll, Re, Re, Re, Rb^Gvs, Rb^Gvs, Rb^Gvs, Gll, Gll, Gll, Wwg, Wwg, Wwg, Wog, Wwg, Wog, Wwg, Wwg^Bw|, Wwg, Wwg, Wwg, Wwg, Wwg, Wwg, Gll, Gll, Gll^Fdf, Hhd, Hhd, Gll^Fdf, Gll^Fdf, Hhd, Mm, Mm, Mm, Mm, Mm, Mm, Mm, Mm, Mm, Mm, Mm, Mm
Gll^Fmf, Ss, Ss, Wwg, Ss, Wwf, Gll, Wwg, Gll, Hhd, Re, Re, Gll^Fmf, Hhd, Re, Rb^Gvs, Rb^Gvs, Rb^Gvs, Gll^Fmf, Gll^Fmf, Hhd, Gll, Gll^Fmf, Gll, Gll, Wwg, Wwg, Wwg, Re, Wwg, Wwg, Wwg, Wwg, Wwg, Wwg, Wwg, Wwg, Gll, Gll, Hhd, Hhd, Hhd, Hhd, Mm, Mm, Mm, Mm, Wwg, Wwg, Mm, Mm, Mm, Mm, Mm, Gg
Ss, Ss, Hhd, Hhd^Fmf, Re, Gll, Gll^Fmf, Gll, Gll^Fmf, Re, Gs^Vc, Rb^Gvs, Rb^Gvs, Gll^Fmf, Gll, Re, Re, Hhd, Rb^Gvs, Rb^Gvs, Rb^Gvs, Gll^Fmf, Re, Gll^Fmf, Rb^Gvs, Gll, Gll^Fmf, Gll, Re, Gll, Gll, Gll, Gll^Fmf, Gll^Fmf, Gll^Fmf, Wwg, Wwg, Wwg, Gll, Gll, Gll^Fdf, Gll^Fdf, Hhd, Mm, Mm, Mm, Mm, Mm, Wwg, Hhd, Mm, Mm, Mm, Mm, Mm
Gll, Gll^Fmf, Hhd, Re, Rb^Gvs, Re, Re, Gll^Fmf, Gll^Fmf, Re, Gll, Rb^Gvs, Rb^Gvs, Rb^Gvs, Gll, Gll, Re, Rb^Gvs, Rb^Gvs, Rb^Gvs, Rb^Gvs, Re, Rb^Gvs, Gd^Vhr, Rb^Gvs, Rb^Gvs, Rb^Gvs, Gll, Re, Gll, Gll, Gll, Rb^Gvs, Gll^Fmf, Gll^Fmf, Gll, Wwg, Wwg, Gll, Hhd, Hhd, Gll^Fdf, Hhd, Hhd, Mm, Mm, Mm, Mm, Wwg, Hhd, Mm, Mm, Mm, Mm, Mm
Gll, Gll, Rb^Gvs, Gs^Vc, Rb^Gvs, Rb^Gvs, Re, Hhd, Re, Re, Gll, Rb^Gvs, Rb^Gvs, Rb^Gvs, Gll^Fmf, Hhd, Re, Gs^Vc, Rb^Gvs, Rb^Gvs, Gll^Fmf, Re, Rb^Gvs, Rb^Gvs, Rb^Gvs, Rb^Gvs, Re, Re, Gll, Gll^Fmf, Gll^Fmf, Rb^Gvs, Rb^Gvs, Rb^Gvs, Rb^Gvs, Gll^Fmf, Wwg, Wwg, Wwg, Gll, Gll, Gll, Gll, Gll, Hhd, Hhd, Mm, Hhd, Wwg, Hhd, Mm, Hhd, Mm, Mm, Mm
Gll^Fmf, Gll, Rb^Gvs, Rb^Gvs, Rb^Gvs, Gll, Re, Re, Rb^Gvs, Rb^Gvs, Rb^Gvs, Gll^Fmf, Gll^Fmf, Gll, Gll, Gll^Fmf, Hhd, Re, Re, Re, Re, Re, Re, Rb^Gvs, Gll, Gll^Fmf, Re, Hhd, Gll, Gll^Fmf, Gll^Fmf, Rb^Gvs, Gd^Vhr, Rb^Gvs, Rb^Gvs, Gll^Fmf, Gll^Fmf, Wwg, Wwg, Wwg, Wwg, Gll, Wwg, Gll, Wwg, Wwg, Wwg, Wwg, Hhd, Hhd, Hhd, Hhd, Mm, Mm, Mm
Gll^Fmf, Gll, Gll, Rb^Gvs, Hhd^Fmf, Gll, Re, Rb^Gvs, Rb^Gvs, Rb^Gvs, Rb^Gvs, Hhd^Fmf, Hhd, Gll, Re, Gll, Hhd, Hhd^Fmf, Rb^Gvs, Rb^Gvs, Rb^Gvs, Re, Re, Re, Re, Re, Rb, Re, Re, Gll, Re, Gll^Fmf, Re, Rb^Gvs, Hhd, Hhd, Hhd, Gll, Hhd^Fdf, Wwg, Wwg, Wwg, Wwg, Wwg, Wog, Wwg, Gll, Gll, Gll^Fdf, Gll^Fdf, Gll^Fdf, Hhd, Mm, Mm, Mm
Gll^Fmf, Gll^Fmf, Gll^Fmf, Gll^Fmf, Hhd, Hhd, Re, Rb^Gvs, Rb^Gvs, Rb^Gvs, Rb^Gvs, Hhd, Re, Re, Rb^Gvs, Re, Re, Rb^Gvs, Rb^Gvs, Rb^Gvs, Rb^Gvs, Rb^Gvs, Re, Hhd^Fmf, Hhd, Rb, Gd^Vhr, Gll, Re, Re, Gll, Re, Gll^Fmf, Re, Re, Gll^Fmf, Gll^Fmf, Gll^Fmf, Gll^Fmf, Hhd^Fmf, Re, Gll, Re, Wwg, Wwg, Wwg, Wwg, Hhd, Gll^Fdf, Gll^Fdf, Hhd, Gll^Fdf, Mm, Mm, Gg
Ss, Gll^Fmf, Ss, Re, Re, Re, Re, Gs^Vc, Gll, Rb^Gvs, Gll, Gll^Fmf, Re, Rb^Gvs, Rb^Gvs, Rb^Gvs, Rb^Gvs, Re, Ce, Ce, Ce, Rb^Gvs, Re, Re, Re, Rb, Rb, Gll, Re, Gll, Gll, Gll^Fmf, Gll^Fmf, Gll^Fmf, Rb^Gvs, Re, Re, Hhd, Re, Re, Gd^Vhr, Re, Rb^Gvs, Hhd, Gll^Fmf, Wwg, Wwg, Gll, Hhd, Gll^Fdf, Hhd, Hhd^Fdf, Hhd^Fdf, Mm, Mm
Ss, Ss, Ss, Gll^Fmf, Gll^Fmf, Gll, Gll, Re, Gll, Gll, Gll, Gll, Re, Rb^Gvs, Gs^Vc, Rb^Gvs, Rb^Gvs, Rb^Gvs, Ce, 6 Ke, Ce, Re, Gll, Gll^Fmf, Gll^Fmf, Re, Re, Re, Gll, Gll, Gll^Fmf, Gll^Fmf, Gll^Fmf, Rb^Gvs, Rb^Gvs, Gd^Vhr, Rb^Gvs, Re, Gll^Fmf, Rb^Gvs, Rb^Gvs, Rb^Gvs, Rb^Gvs, Gll^Fmf, Gll^Fmf, Gll, Wwg, Gll, Hhd^Fdf, Gll^Fdf, Hhd^Fdf, Hhd^Fdf, Hhd^Fdf, Mm, Mm
Gll^Fmf, Ss, Gll^Fmf, Gll^Fmf, Gll^Fmf, Gll^Fmf, Gll^Fmf, Gll^Fmf, Gll^Fmf, Hhd, Gll^Fmf, Gll, Gll, Re, Gll, Gll, Gll, Hhd^Fmf, Gll^Fmf, Ce, Gll, Gll, Gll^Fmf, Gll, Gll^Fmf, Gll^Fmf, Gll^Fmf, Gll, Gll, Gll, Gll, Gll, Gll^Fmf, Rb^Gvs, Rb^Gvs, Rb^Gvs, Rb^Gvs, Rb^Gvs, Hhd^Fmf, Rb^Gvs, Rb^Gvs, Rb^Gvs, Gll, Hhd, Hhd, Gll^Fmf, Wwg, Hhd^Fmf, Hhd, Gll^Fdf, Hhd^Fdf, Hhd, Hhd, Mm, Mm
Gll, Gll^Fmf, Gll, Gll^Fmf, Gll, Gll^Fmf, Gll, Gll^Fmf, Gll, Gll^Fmf, Gll, Gll^Fmf, Gll, Gll, Gll, Gll, Gll, Gll, Gll, Gll^Fmf, Gll^Fmf, Gll^Fmf, Gll, Gll^Fmf, Gll, Gll, Gll, Gll, Gll, Gll, Gll, Gll, Gll, Gll, Gll, Rb^Gvs, Gll, Gll^Fmf, Gll, Hhd, Gll, Gll, Gll, Hhd^Fmf, Hhd, Hhd, Gll, Wwg, Wwg, Hhd, Hhd, Hhd^Fdf, Mm, Mm, Mm
