Gs^Fms, Gs^Fms, Ww, Gs^Fms, Gs^Fds, Gs^Fms, Gs^Fds, Gs^Fds, Gs^Fms, Gs^Fds, Gs^Fms, Gs^Fds, Gs^Fms, Gs, Gs^Fms, Gs^Fds, Gs^Fds, Gs^Fds, Gs^Fds, Gs^Fds, Re, Ww, Rb^Gvs, Rb^Gvs, Rb^Gvs, Gs^Fms, Gs^Fds, Gs, Gs^Fds, Gs^Fds, Gs^Fms, Hh^Fds, Gs^Qhhf, Hh^Fds, Gs^Fms, Hh^Fds, Hh^Fds, Hh^Fds, Hh^Qhhf, Hh^Fds, Hh^Qhhf, Ww, Gs^Fds, Gs^Fms, Gs^Fms, Re, Gs^Fms, Gs^Fms, Gs^Fds
Gs^Fds, Gs^Fds, Ww, Gs^Fds, Gs^Fds, Gs^Fds, Gs^Fms, Gs^Fds, Gs^Fms, Gs^Fms, Gs^Fds, Gs^Fms, Gs^Fds, Gs^Fms, Gs^Fds, Gs^Fds, Gs^Fds, Gd^Fds, Ww, Ww, Ww^Bw|, Ww, Rb^Gvs, Rb^Gvs, Rb^Gvs, Gs^Fds, Gd^Fds, Gs^Fds, Ww, Gs^Fms, Ww, Ww, Ww, Gs^Qhhf, Hh^Qhhf, Hh^Qhhf, Hh^Fds, Hh^Qhhf, Hh^Qhhf, Gs^Fms, Ww, Ww, Gs^Fms, Gs^Fds, Re, Re, Gd^Fds, Gs^Fms, Gs^Fms
Gs^Fds, Gs^Fds, Gs^Fds, Ww, Gs^Fds, Gs^Fms, Rb^Gvs, Gs^Fms, Rb^Gvs, Gs^Fms, Gs^Fds, Gs^Fds, Gs^Fms, Gs^Fds, Gs^Fds, Gs^Fds, Ww, Gs^Fms, Ww, Gs^Fds, Re, Rb^Gvs, Gs^Vl, Rb^Gvs, Gs^Fds, Gs^Fds, Ww, Ww, Gs^Qhhf, Ww, Gs^Qhhf, Gs^Qhhf, Gs^Fms, Ww, Ww, Wwr, Ww, Wwr, Ww, Ww, Ww, Gs^Fds, Gs^Fds, Gs^Fds, Re, Rb^Gvs, Rb^Gvs, Gs^Fms, Gs^Fds
Gs^Fms, Gs^Fds, Ww, Ww, Gs^Fms, Gs^Fds, Gs^Fms, Rb^Gvs, Rb^Gvs, Rb^Gvs, Rb^Gvs, Rb^Gvs, Gs^Fds, Gs^Fms, Hh^Fds, Wwr, Gs^Qhhf, Wwr, Gs^Qhhf, Gg, Re, Rb^Gvs, Rb^Gvs, Rb^Gvs, Hh, Gs^Fms, Ww, Gs^Qhhf, Hh^Qhhf, Gs^Fds, Hh^Qhhf, Gs^Fds, Rb^Gvs, Gs^Qhhf, Gs^Qhhf, Gs^Fds, Gs^Fds, Gs^Qhhf, Gs^Fds, Gs^Fms, Ww, Gs^Fms, Re, Gs^Vl, Re, Rb^Gvs, Rb^Gvs, Gs^Fms, Gs^Fds
Gs^Fds, Gs^Fms, Ww, Gs^Fds, Gs^Fds, Gs^Fms, Gs^Vl, Rb^Gvs, Rb^Gvs, Rb^Gvs, Gs^Fms, Rb^Gvs, Gs^Fds, Gs^Fms, Hh^Fds, Ww, Hh^Qhhf, Hh^Qhhf, Gs^Qhhf, Gs^Fds, Re, Rb^Gvs, Hh, Hh, Mm^Vl, Hh^Fms, Hh^Qhhf, Gs^Qhhf, Hh^Qhhf, Hh^Qhhf, Gs^Fds, Gs^Fms, Rb^Gvs, Rb^Gvs, Rb^Gvs, Gs^Fds, Rb^Gvs, Gs^Fms, Re, Re, Re, Ww^Bw/, Rb^Gvs, Re, Rb^Gvs, Rb^Gvs, Rb^Gvs, Gs^Fms, Gs^Fds
Gs^Fds, Gs^Fds, Ww, Gs^Fms, Ww, Gs^Fds, Gs^Fms, Gg, Gg, Gg, Gs^Fms, Gs^Fds, Gs^Fds, Hh, Hh^Fds, Wwr, Hh^Qhhf, Hh^Qhhf, Gs^Fds, Gg, Re, Hh, Hh, Mm^Ebn, Mm, Mm^Ebn, Hh^Fms, Hh^Qhhf, Hh^Fms, Gs^Qhhf, Gs^Fds, Rb^Gvs, Rb^Gvs, Rb^Gvs, Re, Rb^Gvs, Re, Re, Rb^Gvs, Rb^Gvs, Rb^Gvs, Ww^Ewl, Ww, Rb^Gvs, Gs^Fds, Rb^Gvs, Gs^Fds, Gs^Fds, Gs^Fds
Gs^Fds, Gs^Fds, Gs^Fds, Ww, Gs^Fds, Ww, Gs^Fms, Gs^Fds, Gg, Gg^Efm, Gs^Fds, Gs^Fms, Wwr, Hh^Fds, Hh^Fds, Hh^Fds, Hh^Qhhf, Gs^Qhhf, Gg^Eff, Gg, Gs, Re, Hh, Hh, Hh, Hh, Hh, Hh^Fms, Hh, Gs^Fds, Re, Re, Re, Re, Gs^Fds, Re, Gs^Fds, Rb^Gvs, Gs^Fms, Rb^Gvs, Rb^Gvs, Gs^Fms, Ww, Gs^Fms, Ss, Gs^Fms, Gs^Fms, Gs^Fds, Gs^Fds
Gs^Fds, Gs^Fds, Gs^Fms, Gs^Fms, Gs^Fms, Ww, Ww, Ww, Ww, Gg, Ww^Bw\, Ww, Gs^Fms, Hh^Fds, Gs^Fds, Gs^Fms, Rb^Gvs, Rb^Gvs, Rb^Gvs, Gg^Eff, Gs, Re, Re, Hh, Re, Hh, Re, Hh, Re, Re, Re, Ce, Re, Gs^Fms, Gs^Fds, Gs^Fms, Gs^Fds, Gs^Fms, Gs^Fds, Gs^Fms, Gs^Fds, Gs^Fds, Ss, Ww, Ww, Ss, Gs^Em, Gs^Fms, Gs^Fds
Gs^Fds, Gs^Fds, Gs^Qhhf, Gs^Qhhf, Gs^Qhhf, Gs^Fds, Gs^Fds, Gs^Fms, Gs^Fds, Ww^Ewf, Gg, Re, Re, Gs^Fms, Re, Rb^Gvs, Gs^Vl, Rb^Gvs, Rb^Gvs, Gs, Gs, Re, Gs^Qhhf, Re, Re, Re, Gs^Qhhf, Re, Gs^Qhhf, Gs^Qhhf, Gs^Fds, Re, Re, Gs^Fds, Gs^Fms, Gs^Fms, Gs^Fms, Gs^Fms, Gs^Fds, Gs^Fds, Gg^Fds, Gs^Fms, Gs^Fds, Gs^Emf, Ss, Ss, Ss, Gs^Fms, Gs^Fms
Gs^Fds, Gs^Fds, Gs^Fds, Gs^Fds, Gs^Qhhf, Gs^Fds, Gs^Qhhf, Gs^Qhhf, Gg, Gg, Gs^Qhhf, Gs^Fds, Rb^Gvs, Re, Rb^Gvs, Re, Re, Rb^Gvs, Re, Re, Re, Re, Hh^Fds, Gs^Qhhf, Gs^Qhhf, Gs^Qhhf, Gd^Qhhf, Gs^Fds, Gs^Qhhf, Gs^Fms, Gg, Gg, Re, Gs^Fms, Gs^Fds, Gs^Vl, Gs^Fms, Gs^Fms, Gs^Fms, Gs^Fds, Gs^Fms, Gs^Fms, Gs^Fds, Gs^Fms, Gs^Fms, Gs^Fds, Gs^Fms, Gs^Fds, Gs^Fds
Gs^Fms, Gs^Fds, Gd^Fds, Gs^Fds, Gs^Qhhf, Gs^Qhhf, Rb^Gvs, Rb^Gvs, Rb^Gvs, Gs^Qhhf, Gs^Qhhf, Gs^Qhhf, Rb^Gvs, Rb^Gvs, Re, Re, Re, Re, Rb^Gvs, Rb^Gvs, Rb^Gvs, Hh, Hh, Gs^Fds, Hh^Fds, Hh^Fds, Wwr, Gs^Fds, Gs^Fds, Gs^Fds, Gs^Fms, Gg^Eff, Gg^Eff, Re, Re, Re, Re, Gs^Fms, Ww, Gs^Fds, Ww, Gs^Fms, Gs^Fds, Gs^Fms, Gd^Fds, Gs^Fds, Gs^Fds, Gs^Fds, Gs^Fms
Gs^Fms, Gs^Fms, Gs^Fms, Gs^Qhhf, Rb^Gvs, Rb^Gvs, Rb^Gvs, Rb^Gvs, Rb^Gvs, Gs^Qhhf, Gs^Fds, Gs^Fms, Gs^Fms, Rb^Gvs, Re, Ce, Re, Rb^Gvs, Rb^Gvs, Rb^Gvs, Hh^Fds, Hh^Fds, Hh^Fds, Hh^Fds, Wwr, Hh, Ww, Ww, Ww, Ww, Ww, Gg, Gg^Efm, Gg, Ww, Ww, Ww^Bw|, Ww, Wo, Wo, Wo, Wo, Wo, Gs^Fms, Ww, Ce, Gs^Fds, Gs^Fds, Ww
Gs^Fms, Gs^Fds, Gs^Fms, Gs^Qhhf, Rb^Gvs, Rb^Gvs, Gs^Vl, Rb^Gvs, Rb^Gvs, Rb^Gvs, Re, Re, Re, Re, Gg, Re, Gg, Re, Gg^Eff, Gs^Fds, Gs^Fms, Hh^Fds, Hh^Fds, Hh, Hh^Fds, Ww, Gs^Fms, Gs^Fds, Gs^Fds, Gs^Fds, Ww, Gg, Gg, Gg, Ww, Ww, Re, Ww^Ewl, Gs^Fds, Ww, Gs^Fds, Ww, Ww, Wo, Ww, Ww, Ww, Ww, Ww
Gs^Fds, Gs^Fms, Gs^Fds, Gs^Fds, Gs^Fms, Rb^Gvs, Gs^Fms, Rb^Gvs, Rb^Gvs, Re, Gg, Gs^Fms, Gs^Fds, Gg, Gs^Fds, Gg, Gs^Fms, Re, Re, Gg^Eff, Gs^Fms, Gs^Fds, Gs^Fms, Gs^Fds, Gs^Fds, Gs^Fms, Gs^Fms, Gs^Fms, Gs^Fds, Gs^Fms, Gs^Fds, Ww, Ww, Ww, Wo, Ww, Re, Gs^Fds, Gs^Fds, Gs^Fms, Gs^Fds, Gs^Fms, Gs^Fms, Ww, Gs^Fds, Ww, Ww, Ww, Gs^Fds
Gs^Fds, Gs^Fds, Gs^Fms, Gs^Fms, Gs^Fds, Gs^Fds, Gs^Fds, Gs^Fds, Re, Re, Gs^Fds, Gs^Fms, Gs^Qhhf, Gs^Qhhf, Gs^Qhhf, Gs^Fds, Gs^Fds, Gg^Efm, Gs^Fms, Re, Re, Gg, Re, Re, Rb, Re, Re, Gs^Fms, Re, Gs^Vl, Gs^Fds, Gs^Fms, Ww, Wo, Ww, Gs^Fms, Gs^Fds, Re, Gs^Vl, Gs^Fds, Re, Gs^Fds, Gs, Gs^Fms, Gs^Fds, Gs^Fds, Gs^Fms, Gs^Fds, Gs^Fds
Gs^Fds, Gs^Fds, Gs^Fds, Gs^Fds, Gs^Fms, Gs^Fds, Re, Re, Ket, Re, Re, Gs^Fds, Gs^Fms, Gs^Qhhf, Gs^Qhhf, Gs^Fds, Gs^Qhhf, Gs^Qhhf, Gs^Qhhf, Gg, Gs^Fms, Rb, Rb, Rb, Ket, Rb, Re, Re, Gs^Eff, Re, Re, Gs, Ww, Wo, Gs^Fms, Gs^Fds, Gs^Fds, Re, Re, Re, Ket, Re, Re, Gs, Gs, Gs^Fds, Gs^Fds, Gs^Fms, Gs^Fms
Gg, Gs^Fds, Gs^Fds, Gs^Fms, Gg, Re, Ce^Ebn, Ce, Ce, Ce^Edt, Ce^Ebn, Re, Gs, Gg^Efm, Gs^Qhhf, Gs^Fds, Gs^Fms, Gs^Fds, Gs^Qhhf, Gs^Qhhf, Gs^Fms, Re, Ce^Ebn, Ce, Cvr, Ce^Edt, Ce^Ebn, Re, Gs, Gs^Eff, Gs, Re, Ww^Bw\, Ww, Gs, Gs^Fms, Gs, Re, Ce^Ebn, Ce, Cvr, Ce, Ce^Ebn, Re, Gs^Fms, Gs^Fds, Gs^Fds, Gs^Fds, Gs^Fms
Gg, Gs^Fms, Gs^Fds, Gg, Gg, Re, Ce^Edt, Ce^Vl, 6 Ket, Ce^Vl, Ce, Re, Gs, Gs, Gs, Gs^Fds, Gs^Fds, Gs^Qhhf, Gs, Gs, Gs, Re, Ce, Ce^Vl, 5 Ket, Ce^Vl, Ce, Re, Gs, Gs, Ww, Ww, Ww, Ww^Bw\, Re, Gs, Gs, Re, Ce, Ce^Vl, 4 Ket, Ce^Vl, Ce, Re, Gs^Fds, Gs^Fds, Gs^Fms, Gs^Fds, Gs^Fds
Gs, Gg, Gs, Gs, Gs, Re, Ce^Ebn, Ce^Vl, Ce, Ce^Vl, Ce^Ebn, Re, Re, Gs, Gs, Gs^Fms, Re, Gs^Qhhf, Gs, Gs, Re, Re, Ce^Ebn, Ce^Vl, Ce, Ce^Vl, Ce^Ebn, Re, Gs, Ww, Wo, Wo, Gs, Gs, Gs, Re, Re, Rb, Ce^Ebn, Ce^Vl, Cvr, Ce^Vl, Ce^Ebn, Re, Gs, Gs^Fms, Gs^Fds, Gd^Fds, Gs^Fms
Gs, Gs, Gs, Gs, Ce, Re, Re, Ket, Ce^Ebn, Ket, Re, Re, Ce, Re, Re, Re, Ce, Re, Re, Re, Ce, Rb, Rb, Ket, Ce^Ebn, Ket, Re, Re, Ce, Ww, Ww, Gs, Ce, Gs, Re, Re, Ce, Rb, Rb, Ket, Ce^Ebn, Ket, Rb, Rb, Ce, Gs, Gs^Fds, Gs^Fms, Gs^Fms
Gs^Fds, Gs, Gs, Gs, Gs, Re^Bw\, Ce, Re, Re, Re, Ce, Gs^Bw/, Gs, Gs, Gs, Gs, Gs, Gs, Gs, Gs, Gs, Re^Bw\, Ce, Re, Re, Re, Ce, Re^Bw/, Wo, Ww, Ww, Gs, Gs, Re, Gs^Eff, Gs, Gs, Re^Bw\, Ce, Re, Re, Re, Ce, Re^Bw/, Gs, Gs, Gg, Gs^Fds, Gd^Fds
Ww, Ww, Wo, Ww, Ww, Ww, Ww, Wwf, Wwf, Wwf, Ww, Ww, Ww, Ww, Wo, Gs, Ww, Gs, Ww, Gs, Ww, Ww, Ww, Wwf, Wwf, Wwf, Ww, Wo, Wo, Wo, Gd^Fds, Gd^Fds, Re^Gvs, Re^Vl, Re^Gvs, Gs^Eff, Gs^Eff, Gs, Gs, Gs, Gs, Re, Re, Gs, Gd^Fds, Gs, Gs, Gs^Fds, Gs^Fds
Ww, Ww, Ww, Wo, Ww, Ww, Ww, Wwf, Wwf, Wwf, Ww, Ww, Ww, Wo, Ww, Wo, Wo, Wo, Wo, Wo, Ww, Ww, Ww, Wwf, Wwf, Wwf, Ww, Ww, Ww, Gs^Eff, Gs^Eff, Re^Gvs, Re^Gvs, Re^Gvs, Gs^Eff, Gs^Eff, Gs, Gs, Gs, Gs, Re^Gvs, Re^Gvs, Re^Gvs, Gs^Fds, Gd^Fds, Gd^Fds, Gs, Gs, Ww
Gd, Gd, Gd, Gd, Gd, Gd, Gd, Gd, Re, Gd, Gd, Gd, Gs, Gs, Gs, Ww, Gs, Ww, Gs, Ww, Gs, Gs, Gs, Gd, Re, Gd, Gd, Gd, Gs, Wwf^Es, Wwf^Es, Gs^Eff, Gs^Eff, Gs^Eff, Ww, Gs, Gs, Gs, Gs, Gs^Eff, Gs^Eff, Gs^Vl, Gs^Eff, Gs^Eff, Gd^Fds, Gd^Fds, Ww, Ww, Gd
Gd, Gd, Gd, Gd, Gd^Edb, Gd, Gd, Gd, Re, Gd, Gd^Edb, Gs^Vc, Gs^Edb, Gs, Gs, Gs^Efm, Gs, Gs, Gs, Gs, Gs, Gs, Gs, Gd, Re, Gd, Gd, Gs, Gs, Gs, Wwf^Es, Gs, Ww, Ww, Gd, Wwf^Es, Wwf^Es, Wwf^Es, Ww, Ww, Wwf^Es, Gs, Wwf^Es, Gd^Fds, Gd^Fds, Gs, Ww, Gd, Gd
Hhd, Gd, Gd, Gs^Vc, Gd^Edb, Gd^Edb, Gd, Gd, Re, Gd, Gd, Gd^Edb, Gd, Gs, Gd, Gs, Hhd, Gs, Hhd, Gs, Gs, Gs, Gs, Gs, Gd, Re, Gd, Gs, Gs, Gs, Gs, Ww, Gd, Gd, Gd, Gd, Gd, Gd, Gd, Gd, Gd, Wwf^Es, Gd, Ww, Ww, Ww, Gd, Gd, Gd
Hhd, Gd, Hhd, Gd, Hhd, Gd, Gd, Gd, Gd, Re, Re, Gd^Edb, Gd, Gs^Efm, Gd, Hhd, Rd, Hhd, Rd, Hhd, Gs, Gs, Gs^Edb, Gd^Edb, Gd, Re, Gd, Gd, Gs, Gs, Gs, Gs, Gs, Gd, Gs^Vc, Gd, Gd, Gd, Gd, Gd, Gd, Gd, Gd, Gd, Gd, Gd, Gd, Gs, Gs
Hhd, Hhd, Hhd, Hhd, Hhd, Gd, Hhd, Gd, Gd, Gd, Re, Gd, Gd, Gs, Gd, Rd, Rd, Rd, Rd, Gd, Gd, Gd, Gd, Gs^Vc, Gd, Re, Gd, Gd, Gd, Gs, Gs, Gs, Gs, Gd^Edb, Gd^Edb, Gd^Edb, Gd, Gd, Gs, Gd, Gs, Gd, Gs, Gd, Gs, Gd, Gs, Gs, Gs
Hhd, Hhd, Rd, Gd, Gd, Gd, Rd, Rd, Gd, Gd, Re, Gd, Gd, Gd, Gd, Gd, Gs, Gs, Gs, Rd, Gs, Gs, Gd, Gd, Gd, Re, Re, Gd, Gd, Gs, Gs, Gs, Gs, Gs, Hhd, Gd^Edb, Hhd, Gs, Gd, Gs, Gs, Gs, Gs, Gs, Gs, Gs, Gs, Gs, Gs
Hhd, Hhd, Rd^Es, Hhd, Gd, Gd, Rd, Rd, Gd, Gd, Re, Gd, Gd, Gd, Gd, Gs, Gs, Gs, Gs, Gs, Gd, Gd, Gd, Gd, Gd^Edb, Gd^Edb, Gd, Re, Re, Gd, Gs, Gs, Rd, Rd, Rd^Es, Hhd, Hhd, Gd^Ecf, Gd, Gd, Gd, Gd, Gd, Gs, Gd, Gs, Gs, Gs, Gd
Hhd, Hhd, Hhd, Rd, Re^Vct, Re^Vct, Ce, Ce, Ce, Re, Re, Re, Ce, Gd, Re, Gd, Gd, Gd, Gd, Gd, Hhd, Hhd, Rd, Gd^Edb, Gs^Vc, Gd^Edb, Gd^Edb, Gd, Re, Gd, Gd, Gs, Hhd, Rd, Rd^Es, Hhd, Rd^Es, Gd, Cer, Cer, Cer, Gd, Gd, Gd, Gd, Gd, Gd, Gd, Gd
Hhd, Hhd, Hhd, Rd, Rd, Re^Vct, Ce, 2 Ke, Ce, Re, Re, Ce, 1 Ke, Ce, Re^Vct, Re^Vct, Gd, Gd, Hhd, Rd, Rd^Es, Rd^Es, Rd, Gd, Gd, Gd, Gd, Gd, Re, Gd, Gd, Gd, Hhd, Rd^Es, Hhd, Rd^Es, Rd^Ecf, Gd, Cer, 3 Ke, Cer, Gd, Re^Vct, Gd, Gd, Gd, Gd, Gd, Gd
Hhd, Hhd, Hhd, Hhd, Rd^Es, Gd, Gd, Ce, Gd, Re, Re, Ce, Ce, Ce, Gd, Re^Vct, Gd, Gd, Hhd, Hhd, Rd^Es, Hhd, Hhd, Hhd, Hhd, Gd, Gd, Gd, Gd, Re, Gd, Hhd, Gd, Hhd, Hhd, Rd^Es, Rd, Rd, Gd, Cer, Gd, Gd, Gd^Ecf, Gd, Gd, Gd, Gs, Gd, Gs
Hhd, Hhd, Hhd, Rd^Es, Hhd, Rd, Rd, Gd, Re, Re, Rd, Rd, Rd, Rd, Hhd, Gd, Hhd, Hhd, Hhd, Hhd, Hhd, Hhd, Hhd, Hhd, Hhd, Hhd, Gd, Gd, Gd, Re, Re, Gd, Gd, Hhd, Hhd, Rd, Hhd, Rd, Gd, Gd, Gd, Re^Vct, Gd, Gd, Gd, Gd, Gs, Gs, Gs
Hhd, Hhd, Hhd, Hhd, Hhd, Hhd, Gd, Gd, Re, Re, Rd, Rd, Gd, Hhd, Gd, Hhd, Gd, Hhd, Gd, Hhd, Gd, Hhd, Gd, Hhd, Hhd, Hhd, Hhd, Hhd, Gd, Gd, Re, Gd, Gd, Hhd, Hhd, Hhd, Hhd, Gd, Gd, Gd, Gd, Gd, Gd, Gd, Gd, Gd, Gs, Gs, Gd
