Gs, Gs, Wwf, Gs, Gs, Gs, Gs, Gs, Gs, Gs, Gs, Gs, Gs^Efm, Gs, Gs^Efm, Gs, Gs, Gs, Gs, Gs, Re, Wwf, Gs, Gs, Gs, Gs, Gs^Efm, Gs, Gs^Efm, Gs, Gs, Gs, Gg, Gs, Gs, Gs, Gs, Gs, Gs, Gs, Gs, Wwf, Gs^Fds, Gs^Fds, Gs^Fds, Gs, Gs^Fds, Gs, Gs
Gs, Gs, Wwf, Gs, Gs, Gs^Efm, Gs^Em, Gs^Efm, Gs^Fds, Gs, Gs^Fds, Gs^Efm, Gs^Efm, Gs^Efm, Gs^Efm, Gs^Efm, Gs^Efm, Gs, Wwf, Wwf, Wwf^Bw|, Wwf, Gs^Gvs, Gs^Gvs, Gs^Gvs, Gs^Efm, Gs, Gs^Efm, Gs, Gs, Gg, Gg, Gg^Fds, Gg, Gg^Efm, Gg^Efm, Gg^Efm, Gs^Efm, Gg, Gs, Wwf, Wwf, Gs, Gs^Fds, Gs^Gvs, Gs^Fds, Gs^Efm, Gs^Efm, Gs
Gs, Gs, Gs, Wwf, Gs, Gs, Gs^Fds, Gs^Fds, Gs^Fds, Gs^Fds, Gs, Gs, Gs, Gs^Efm, Gs, Gs^Efm, Wwf, Gs, Wwf, Gs, Re, Gs, Gs^Vl, Gs^Gvs, Gg^Gvs, Gg^Gvs, Gg, Gg^Fds, Gg^Fds, Gg^Fds, Hh^Fms, Hh^Fms, Hh^Fds, Hh^Fms, Hh^Fms, Hh^Fms, Hh^Fms, Gg^Fds, Hh^Fms, Gg, Wwf, Gs, Gs, Gs^Gvs, Gs^Gvs, Gs^Gvs, Gs^Fds, Gs^Fds, Gs
Gs, Gs, Wwf, Wwf, Gs, Gs, Gs^Gvs, Gs^Gvs, Gs^Gvs, Gs^Fds, Gg, Gs^Em, Gg^Em, Gs, Gs, Wwf, Gg, Wwf, Gg, Re, Gs, Gs, Gg^Em, Gg, Hh^Fds, Gg, Gg^Fds, Gg^Fds, Hh^Fms, Hh^Fms, Hh^Fds, Hh^Fds, Hh^Fms, Hh^Fds, Hh^Fms, Hh^Fms, Hh^Fds, Hh^Fds, Gg^Em, Gg^Fds, Wwf, Gs, Gs, Gs^Vl, Gs^Gvs, Gs^Gvs, Gs, Gs^Fds, Gg
Gs, Gs, Wwf, Gs, Gs, Gs^Efm, Gs^Vl, Gs^Gvs, Gg^Gvs, Gs, Gg^Fds, Gg^Fds, Gg^Fds, Gg, Gg, Wwf, Gg, Gg, Gg, Re, Re, Gg, Hh^Fds, Hh^Fds, Mm^Vl, Hh^Fds, Hh^Fds, Gg^Fds, Gg^Efm, Hh^Fms, Gg^Fds, Hh^Fds, Gg^Gvs, Gg^Fds, Gg^Gvs, Hh^Fms, Gg^Efm, Gg^Fds, Gg^Efm, Gg, Gg, Wwf^Bw/, Gg, Gg, Gg^Fds, Gs, Gg^Em, Gg^Em, Gg^Fds
Gs, Gs, Wwf, Gs, Wwf, Gs, Gs, Gs^Gvs, Gg, Gg, Gg^Fds, Hh^Fms, Hh^Fds, Hh^Fms, Hh^Fds, Wwf, Hh^Fms, Hh^Fms, Hh^Fms, Gg, Re, Gg, Hh^Fds, Mm^Ebn, Mm, Mm^Ebn, Hh^Fds, Gg^Efm, Gs^Efm, Gg^Efm, Gg^Efm, Gg^Gvs, Gs, Gs^Vl, Gg^Gvs, Gg^Gvs, Gg^Gvs, Gg^Efm, Gg^Fds, Hh^Fms, Hh^Fms, Wwf, Wwf, Gg, Hh^Fds, Gg^Fds, Hh^Fms, Hh^Fds, Hh^Fms
Gs, Gs, Gs, Wwf, Gg, Wwf, Gs, Gg, Gg, Hh^Fms, Hh^Fms, Hh^Fms, Hh^Fms, Hh^Fms, Hh^Fms, Hh^Fms, Hh^Fms, Hh^Fms, Gg^Fds, Hh^Fms, Re, Gg, Gg, Hh^Fds, Hh, Hh^Fds, Gg, Gg, Gs, Gs^Efm, Gs, Gs^Efm, Gg, Gg, Hh^Fms, Gg^Gvs, Hh^Fms, Hh^Fds, Hh^Fds, Hh^Fms, Hh^Fms, Hh^Fms, Wwf, Hh^Fms, Hh^Fms, Hh^Fms, Mm^Fms, Mm^Fms, Mm^Fms
Gg^Efm, Gg^Efm, Gg^Efm, Gg^Efm, Gg^Efm, Wwf, Wwf, Wwf, Wwf, Gg, Wwf^Bw\, Wwf, Gg^Efm, Gg^Efm, Gg^Efm, Gg^Fds, Gg^Gvs, Gg^Em, Gs^Fds, Gg^Fds, Gs, Re, Re, Re, Re, Re, Re, Gg, Re, Re, Re, Ce, Gg, Gg^Fds, Hh^Fms, Hh^Fms, Hh^Fms, Hh^Fds, Wwf, Hh^Fms, Hh^Fms, Hh^Fms, Hh^Fms, Hh^Fms, Mm^Fds, Mm^Fms, Mm^Fds, Mm^Fds, Mm^Fds
Gg, Gg^Efm, Hh^Fms, Gg, Hh^Fms, Gg, Gg, Gg, Gg, Wwf, Gg, Gs, Gs, Gs, Gs^Gvs, Gs^Gvs, Gs^Vl, Gg^Fds, Gs, Gs^Fds, Gs, Re, Gs^Fds, Gs, Gg, Gs, Gs, Re, Gs, Gs, Gs, Re, Re, Hh^Fms, Gg, Gg^Fds, Gg^Gvs, Gg^Fds, Gs, Wwf, Gg^Fds, Hh^Fms, Gg^Fds, Hh^Fds, Gg^Fds, Hh^Fms, Gg^Fds, Gg^Fds, Gg^Fds
Hh^Fms, Hh^Fms, Mm^Fms, Hh^Fms, Hh^Fms, Hh^Fms, Hh^Fms, Hh^Fms, Hh^Fms, Hh^Fms, Hh^Fms, Gg^Fds, Gg^Fds, Gs, Gs, Gs^Gvs, Gs, Gs, Re, Gs, Re, Re, Gg^Em, Gg, Gg^Em, Gg, Gg^Em, Gg, Gg^Fds, Gg^Fds, Hh^Fms, Gg, Re, Gg, Gg, Gs^Vl, Gs^Gvs, Gs^Gvs, Gs^Gvs, Wwf, Wwf, Gg, Gs, Gg^Fds, Gs^Efm, Gg^Efm, Gg^Fds, Gg^Fds, Gg^Fds
Gs^Fds, Mm^Fms, Hh^Fds, Mm^Fms, Hh^Fms, Hh^Fms, Hh^Fms, Hh^Fms, Hh^Fds, Hh^Fds, Gg^Fds, Hh^Fms, Gg, Gg, Re, Re, Re, Re, Gg, Re, Gg, Gg^Fds, Hh^Fds, Hh^Fms, Hh^Fms, Hh^Fms, Hh^Fms, Hh^Fds, Hh^Fds, Hh^Fms, Hh^Fds, Gg^Fds, Gg, Re, Gs, Gs^Gvs, Gs^Gvs, Gs^Gvs, Gs^Efm, Gs, Wwf, Gs, Gs, Gs^Fds, Gs, Gs^Efm, Gs^Efm, Gs^Fds, Gs^Fds
Gg, Hh^Fds, Gg^Fds, Hh^Fms, Gg, Gg^Fds, Gg, Hh^Fms, Gg, Gg^Em, Gg, Gg, Gg, Re, Gs, Ce, Re, Gg, Gg^Fds, Gg^Fds, Hh^Fds, Hh^Fds, Hh^Fms, Hh^Fms, Hh^Fds, Mm^Fms, Mm^Fms, Hh^Fms, Hh^Fds, Wwf, Wwf, Hh^Fds, Re, Re, Gs, Gs, Wwg, Gs, Wwg, Gs, Wwf, Gs, Wwg, Gs, Gs, Ce, Gs, Gs, Gs
Gs^Efm, Gg^Efm, Gg^Efm, Gg^Efm, Gg^Efm, Gg, Gs^Vl, Gg, Gs, Gg, Re, Gs, Re, Re, Gs, Gs, Re, Gs, Gg, Hh^Fms, Hh^Fms, Hh^Fms, Gg, Gg^Fds, Gg, Gg^Fds, Gg^Fds, Hh^Fms, Hh^Fms, Hh^Fms, Wwf, Gg, Re, Gs, Gs, Wwg, Wwg, Wwg, Wwg, Wwg, Wwg, Wwg, Wwg, Wwg, Wwg, Gs, Wwg, Gs, Gs
Gs^Fds, Gg^Efm, Gg^Fds, Gg^Efm, Gg, Gg, Gs, Gs, Re, Re, Gs, Re, Gs^Fds, Gs^Fds, Gg^Fds, Gg^Fds, Gg^Efm, Re, Re, Gg^Efm, Re, Hh^Fms, Gg, Gs, Gs^Efm, Gg^Efm, Gg^Efm, Gg^Efm, Gg^Gvs, Gg^Fds, Gg^Gvs, Wwf, Wwf, Wwf, Wwg, Wwg, Gs, Gs, Gs, Wwg, Gs, Gs, Gs, Wwg, Gs, Wwg, Wwg, Wwg, Wwg
Hh^Fms, Hh^Fms, Hh^Fms, Hh^Fms, Gg^Efm, Gs^Efm, Gs, Gs, Re, Gs, Gs^Efm, Gs, Gs, Gg^Em, Hh^Fds, Gg^Efm, Hh^Fms, Gg^Efm, Gg, Re, Gg, Re, Re, Gs, Gs, Gs, Gs, Gs^Gvs, Gs^Gvs, Gs^Vl, Re, Re, Gs, Gs, Wwg, Wwg, Gs, Gg^Gvs, Gg^Vl, Gs^Gvs, Gg, Gg^Efm, Gg^Efm, Gs, Gs, Gs, Gs, Wwg, Wwg
Gg^Fds, Hh^Fms, Gg^Fds, Gg^Fds, Gs^Efm, Gs^Efm, Gs, Gs, Ket^Bw/, Gs, Gs, Gs^Efm, Gg^Fds, Gg^Fds, Hh^Fds, Hh^Fms, Mm^Fms, Hh^Fms, Hh^Fds, Gg^Fds, Gs, Gs, Re, Gs, Ket^Bw/, Gs, Gs, Gs, Gs, Gs^Gvs, Re, Gs, Gs, Gs, Wwg, Wwg, Gs, Gg^Gvs, Gg^Gvs, Gg^Gvs, Ket^Bw/, Gs^Efm, Gs, Gs, Gs^Efm, Gs, Gs, Wwg, Wwg
Hh^Fms, Gg^Fds, Gg^Em, Gs^Efm, Gs^Efm, Gs^Efm, Ce^Bw|, Ce^Bw/, Cvr^Vl, Ce^Bw\, Ce^Bw\, Gs, Gg, Hh^Fds, Gg^Efm, Hh^Fms, Gg^Fds, Hh^Fms, Gg^Em, Gg^Fds, Gs, Gs, Ce^Bw|, Ce^Bw/, Cvr^Vl, Ce^Bw\, Ce^Bw\, Gs, Gs, Re, Gs, Re, Wwg^Bw\, Wwg, Wwg, Gs, Gg, Gg, Ce^Bw|, Ce^Bw/, Cvr^Vl, Ce^Bw\, Ce^Bw\, Gs, Gg^Fds, Gg^Fds, Gg^Fds, Gs, Gs
Gg, Gg^Fds, Gs, Gs^Efm, Gs, Gs, Ce^Bw|, Cvr^Vl, 6 Ket, Cvr^Vl, Ce^Bw|, Gs, Gs, Gg^Efm, Gs^Efm, Gg^Efm, Gs, Gg^Efm, Gs, Gs, Gs, Gs, Ce^Bw|, Cvr^Vl, 5 Ket, Cvr^Vl, Ce^Bw|, Gs, Re, Re, Gs, Gs, Wwg, Wwg^Bw\, Re, Gs, Gg, Gs, Ce^Bw|, Cvr^Vl, 4 Ket, Cvr^Vl, Ce^Bw|, Gs, Gg^Fds, Hh^Fms, Hh^Fms, Hh^Fms, Hh^Fms
Gs, Gg, Gs, Gs, Gs, Gs, Ce^Bw\, Cvr, Cvr, Cvr, Ce^Bw|, Gs, Gs, Gs, Gs, Gs, Gs, Gs, Gs, Gs, Gs, Gs, Ce^Bw\, Cvr, Cvr, Cvr, Ce^Bw|, Gs, Re, Gs, Wwg, Wwg, Wwg, Gs, Gs, Re, Gs, Gs, Ce^Bw\, Cvr, Cvr, Cvr, Ce^Bw|, Gs, Gg, Hh^Fms, Hh^Fms, Mm^Fms, Mm^Fms
Gs, Gs, Gs, Gs, Ce, Gs, Gs, Ket^Bw\, Ce^Bw\, Ket^Bw/, Gs, Gs, Ce, Re, Re, Re, Ce, Re, Re, Re, Ce, Gs, Gs, Ket^Bw\, Ce^Bw\, Ket^Bw/, Gs, Gs, Ce, Gs, Wwg, Wwg, Ce, Re, Re, Re, Ce, Gs, Gs, Ket^Bw\, Ce^Bw\, Ket^Bw/, Gs, Gs, Ce, Gg, Gg^Efm, Hh^Fms, Hh^Fms
Wwg, Gs, Wwg, Gs, Gs, Gs^Bw\, Ce, Re, Re, Re, Ce, Gs^Bw/, Wwg, Gs, Wwg, Gs, Wwg, Gs, Gs, Gs, Gs, Gs^Bw\, Ce, Re, Gs, Re, Ce, Gs^Bw/, Wwg, Wwg, Wwg, Gs, Gs, Gg, Re, Gg, Gg, Gs^Bw\, Ce, Re, Re, Re, Ce, Gs^Bw/, Gs, Gs, Gg^Efm, Hh^Fms, Hh^Fms
Wwg, Wwg, Wwg, Wwg, Wwg, Wwg, Wwg, Wwf, Wwf, Wwf, Wwg, Wwrg, Wwg, Wwg, Wwg, Wwg, Wwg, Wwg, Wwg, Wwg, Wwg, Wwg, Wwg, Wwf, Wwf, Wwf, Wwg, Wwg, Wwg, Wwg, Gs, Gs, Gg^Gvs, Re^Vl, Gg, Gg^Efm, Gg^Efm, Gs, Gs, Re, Re, Re, Gs, Gs, Gs, Gs, Gs, Gg, Hh^Fms
Gs, Wwg, Gs, Wwg, Wwg, Wwg, Wwg, Wwf, Wwf, Wwf, Gs, Wwg, Gs, Wwg, Gs, Gs, Gs, Gs, Gs, Wwg, Gs, Wwg, Gs, Wwf, Wwf, Wwf, Wwg, Wwg, Gs, Gs, Gs, Gs^Gvs, Gg^Gvs, Gg^Gvs, Gg^Gvs, Gg^Efm, Gg, Gg^Efm, Gs, Gs, Gd^Gvs, Gs, Gs^Gvs, Gs, Gs, Gd^Fmw, Gd^Fmw, Gd^Fmw, Gd^Fmw
Gs, Gs, Gs, Gs, Gs, Gs, Gs, Gs, Gs, Re, Re, Gs^Gvs, Gs^Edb, Gs, Gs^Efm, Gs, Gd^Gvs, Gs, Gs^Gvs, Gs, Gs^Efm, Gs, Gs^Gvs, Gs, Re, Gs, Gs, Wwg, Wwf, Gs, Gs^Efm, Gs, Gd^Gvs, Gs^Gvs, Gs, Gs, Gs, Gs, Gs^Efm, Gd^Gvs, Gs^Gvs, Gs^Vhr, Gs^Fms, Gs^Fms, Gs^Fms, Gd^Fms, Gs^Fmw, Gd^Fmw, Gd^Fmw
Gd, Gd^Efm, Gd^Gvs, Gd^Gvs, Re^Es, Gs^Efm, Re, Gd^Gvs, Re, Gd, Re, Gs^Vhr, Gd^Es, Gd^Gvs, Gd^Fmw, Gd^Fmw, Gd^Fmw, Gd^Fmw, Gd^Fmw, Gd^Gvs, Gd^Efm, Gd^Efm, Re, Re, Gd^Fmw, Gs, Gd^Efm, Gs, Gs, Wwf, Gs^Efm, Gd^Efm, Gs, Gs, Wwf, Gs, Gs, Gs, Gs, Gs^Efm, Wwf, Wwf, Wwf, Gs^Fms, Gs^Fms, Gs^Fms, Hhd^Fms, Hhd^Fms, Gd^Fms
Gd, Gd, Gd^Edb, Re^Vhr, Gd^Gvs, Re, Gd, Re, Gd^Gvs, Re, Gd, Re^Es, Gd^Gvs, Gd^Gvs, Gd, Gd^Fmw, Gd, Gd^Gvs, Gd, Gs, Gd, Gs, Re, Gd, Gd, Gd^Fmw, Gd, Gs^Gvs, Gs, Wwf, Wwf, Gs^Efm, Wwf, Wwf, Gs, Wwf, Wwf^Bp|, Wwf, Wwf, Wwf, Gs^Fmw, Gs^Fmw, Gs^Fmw, Wwf, Gs^Fms, Hhd^Fms, Hhd^Fms, Hhd^Fmw, Hhd^Fmw
Gd^Fms, Gd^Fmw, Gd^Fms, Gd^Gvs, Gd^Fmw, Gd^Efm, Gd^Fms, Gd, Gd^Fmw, Gd, Gd^Gvs, Re, Re, Gd, Re, Gd, Gd^Efm, Gd, Re, Re, Re, Gd^Efm, Re^Es, Gd^Gvs, Gd^Gvs, Gd, Re, Gd, Re, Gs, Gs, Wwf, Gs^Gvs, Gs^Gvs, Gd^Vhr, Gs^Es, Gs, Gs, Gs, Gs^Gvs, Gs^Gvs, Gs^Fmw, Gs^Fmw, Wwf, Wwf, Hhd^Fms, Wwf, Hhd^Fmw, Wwf
Hhd^Fmw, Gd^Fms, Gd^Fms, Gd^Fms, Hhd^Fmw, Gd^Fms, Gd^Fms, Gd^Fmw, Gd^Efm, Gd, Gd, Gd, Re, Re, Gd, Re, Gd, Gd^Efm, Gd, Gd^Efm, Gd, Gd, Gd^Gvs, Gd^Vhr, Gd^Edb, Gd, Gd, Re, Gd^Efm, Re, Gd, Gd, Re, Re, Gd^Edb, Re, Gd^Gvs, Gd, Gd, Gd^Gvs, Gd^Fmw, Gd^Fmw, Gd^Fmw, Gs^Gvs, Gd^Fmw, Wwf, Gd^Fmw, Wwf, Gs
Hhd^Fmw, Hhd^Fmw, Hhd, Hhd, Hhd^Fmw, Hhd^Fmw, Gd^Fms, Gd^Fms, Gd^Efm, Gd^Efm, Gd, Gd, Re, Gd, Gd^Efm, Gd, Gd^Fms, Gd, Gd^Fmw, Gd^Fms, Gd^Fmw, Gd^Fms, Gd^Fms, Gd^Gvs, Gd^Fms, Gd, Gd^Fmw, Gd^Efm, Gd^Efm, Gd^Efm, Gd^Efm, Gd, Gd, Gd^Gvs, Gd^Efm, Gd^Gvs, Gd^Efm, Gd, Gd, Gd, Gd^Efm, Gd^Efm, Gd^Efm, Gd^Efm, Gd^Efm, Gd^Fmw, Gd, Gd^Fmw, Gd^Efm
Hhd^Fmw, Hhd^Fmw, Hhd, Hhd, Hhd^Fmw, Gd^Fmw, Gd, Gd^Efm, Gd^Efm, Gd^Ecf, Re, Re, Gd, Gd^Efm, Gd^Efm, Gd^Efm, Gd^Fms, Gd^Fms, Gd^Fmw, Gd^Fms, Hhd^Fmw, Gd^Fms, Gd^Fmw, Gd^Fmw, Gd^Fms, Gd, Gd^Fms, Gd, Gd^Fms, Gd, Gd^Fmw, Gd, Gd, Gd, Gd, Gd^Efm, Gd, Gd^Efm, Gd, Gd, Gd, Gd, Gd, Gd, Gd, Gd, Gd^Gvs, Gd^Efm, Gd^Efm
Mm, Hhd, Hhd, Hhd, Gd^Vct, Gd^Vct, Ce, Ce, Ce, Gd, Re, Gd, Ce, Gd, Gd, Gd^Fms, Gd^Fmw, Hhd^Fmw, Hhd^Fdw, Hhd^Fmw, Hhd^Fdw, Hhd^Fmw, Hhd^Fmw, Gd^Fmw, Gd^Ve, Gd^Fms, Gd^Fms, Gd^Fms, Gd^Fms, Gd^Fms, Gd^Fms, Gd^Fms, Gd^Fms, Gd^Fmw, Gd, Gd, Gd, Gd, Cer, Cer, Cer, Gd, Gd, Gd, Gd^Gvs, Gd, Gll^Gvs, Gd, Gd
Mm, Mm, Hhd^Fmw, Hhd^Fmw, Hhd, Gd^Vct, Ce, 2 Ke, Ce, Re, Gd, Ce, 1 Ke, Ce, Gd^Vct, Gd^Vct, Hhd^Fmw, Hhd^Fmw, Hhd, Hhd, Hhd, Hhd, Hhd, Gd^Fmw, Hhd^Fmw, Gd^Fmw, Hhd^Fmw, Gd^Fmw, Hhd^Fmw, Gd^Fms, Hhd^Fmw, Gd^Fmw, Gd^Fms, Gd^Fmw, Gd^Fdw, Gd, Gd, Gd, Cer, 3 Ke, Cer, Re, Re, Gd, Gd^Gvs, Gd^Gvs, Gll, Gd, Gll
Mm, Mm, Mm, Hhd^Fmw, Hhd, Gd, Gd, Ce, Gd, Re, Gd, Ce, Ce, Ce, Gd, Gd^Vct, Hhd^Fmw, Hhd, Hhd, Hhd, Hhd, Mm, Hhd, Hhd, Hhd, Hhd, Hhd^Fdw, Hhd^Fmw, Hhd, Hhd^Fmw, Hhd^Fdw, Gd^Fmw, Gd^Fmw, Gd^Fdw, Gd^Fdw, Gd, Gd, Gd, Gd, Cer, Re, Re, Re^Ecf, Gd, Gll, Gll, Gll, Gll, Gd
Mm, Mm, Mm, Hhd^Fmw, Hhd^Fmw, Hhd, Gd, Gd, Gd, Re, Re, Gd, Gd, Gd, Hhd, Hhd^Fmw, Mm, Hhd, Mm, Mm, Mm, Mm, Mm, Mm, Mm, Hhd, Mm, Hhd, Hhd, Hhd, Hhd, Hhd^Fmw, Hhd, Hhd^Fmw, Gd^Fdw, Gd^Fdw, Gd, Gd^Gvs, Gll^Gvs, Gd^Gvs, Gll^Gvs, Re^Gvs, Gd, Re, Gd, Gd, Gd, Gd, Gd
Hhd, Hhd^Fmw, Gd^Fmw, Hhd^Fmw, Gd^Fmw, Hhd, Gd, Gd, Re, Gd, Re, Gs, Gd, Hhd, Gd, Mm, Gd, Mm, Gd, Mm, Gd, Mm, Gd, Mm, Gd, Mm, Gd, Hhd, Gd, Hhd, Gd, Hhd, Hhd, Hhd, Gd, Gd, Gd, Gll, Hh, Gll^Gvs, Gd, Gd, Gd, Re, Gd, Gd^Gvs, Gll, Gll, Gd
