Gg^Fds, Gg^Fds, Ww, Gg^Fds, Gg^Fds, Gg^Fds, Gg^Fds, Gg^Fds, Gg^Fds, Gg^Fds, Gg^Fds, Gg^Fds, Gg^Fds, Gs, Gg^Fds, Gg^Fds, Gg^Fds, Gg^Fds, Gg^Fds, Gg^Fds, Re, Ww, Rb^Gvs, Rb^Gvs, Rb^Gvs, Gs^Fds, Gs^Fds, Gs, Gs^Fds, Gs^Fds, Gs^Fds, Hh^Fds, Gs^Fms, Hh^Fds, Gs^Fms, Hh^Fds, Hh^Fds, Hh^Fds, Hh^Fds, Hh^Fds, Hh^Fds, Ww, Gg^Fds, Gg^Fds, Gg^Fds, Re, Gg^Fds, Gg^Fds, Gg^Fds
Gg^Fds, Gg^Fds, Ww, Gg^Fds, Gg^Fds, Gg^Fds, Gg^Fds, Gg^Fds, Gg^Fds, Gg^Fds, Gg^Fds, Gg^Fds, Gg^Fds, Gg^Fds, Gg^Fds, Gg^Fds, Gg^Fds, Gg^Fds, Ww, Ww, Ww^Bw|, Ww, Rb^Gvs, Rb^Gvs, Rb^Gvs, Gs^Fds, Gs^Fds, Gs^Fds, Ww, Gs^Fds, Ww, Ww, Ww, Gs^Fms, Hh^Fds, Hh^Fds, Hh^Fds, Hh^Fds, Hh^Fds, Gs^Fms, Ww, Ww, Gg^Fds, Gg^Fds, Re, Re, Gg^Fds, Gg^Fds, Gg^Fds
Gg^Fds, Gg^Fds, Gg^Fds, Ww, Gg^Fds, Gg^Fds, Rb^Gvs, Gg^Fds, Rb^Gvs, Gg^Fds, Gg^Fds, Gg^Fds, Gg^Fds, Gg^Fds, Gg^Fds, Gg^Fds, Ww, Gg^Fds, Ww, Gg^Fds, Re, Rb^Gvs, Gs^Vl, Rb^Gvs, Gs^Fds, Gs^Fds, Ww, Ww, Gg^Fds, Ww, Gg^Fds, Gg^Fds, Gg^Fds, Ww, Ww, Wwr, Ww, Wwr, Ww, Ww, Ww, Gg^Fds, Gg^Fds, Gg^Fds, Re, Rb^Gvs, Rb^Gvs, Gg^Fds, Gg^Fds
Gg^Fds, Gg^Fds, Ww, Ww, Gg^Fds, Gg^Fds, Gg^Fds, Rb^Gvs, Rb^Gvs, Rb^Gvs, Rb^Gvs, Rb^Gvs, Gg^Fds, Gg^Fds, Hh^Fds, Wwr, Gs^Fds, Wwr, Gg^Fds, Gg, Re, Rb^Gvs, Rb^Gvs, Rb^Gvs, Hh, Gs^Fds, Ww, Gg^Fds, Hh^Fms, Gg^Fds, Hh^Fms, Gg^Fds, Rb^Gvs, Gg^Fds, Gg^Fds, Gg^Fds, Gg^Fds, Gg^Fds, Gg^Fds, Gg^Fds, Ww, Gg^Fds, Re, Gs^Vl, Re, Rb^Gvs, Rb^Gvs, Gg^Fds, Gg^Fds
Gg^Fds, Gg^Fds, Ww, Gg^Fds, Gg^Fds, Gg^Fds, Gs^Vl, Rb^Gvs, Rb^Gvs, Rb^Gvs, Gg^Fds, Rb^Gvs, Gg^Fds, Gg^Fds, Hh^Fds, Ww, Hh, Hh, Gg^Fds, Gg^Efm, Re, Rb^Gvs, Hh, Hh, Mm^Vl, Hh^Fms, Hh^Fms, Gg^Fds, Hh^Fp, Hh^Fp, Gg^Fds, Gg^Fds, Rb^Gvs, Rb^Gvs, Rb^Gvs, Gg^Fds, Rb^Gvs, Gg^Fds, Re, Re, Re, Ww^Bw/, Rb^Gvs, Re, Rb^Gvs, Rb^Gvs, Rb^Gvs, Gg^Fds, Gg^Fds
Gg^Fds, Gg^Fds, Ww, Gg^Fds, Ww, Gg^Fds, Gg^Fds, Gg, Gg, Gg, Gg^Fds, Gg^Fds, Gg^Fds, Hh, Hh^Fds, Wwr, Hh^Fds, Hh^Fds, Gg^Efm, Gg, Re, Hh, Hh, Mm^Ebn, Mm, Mm^Ebn, Hh^Fms, Hh^Fms, Hh^Fms, Gg^Fds, Gg^Fds, Rb^Gvs, Rb^Gvs, Rb^Gvs, Re, Rb^Gvs, Re, Re, Rb^Gvs, Rb^Gvs, Rb^Gvs, Ww^Ewl, Ww, Rb^Gvs, Gg^Fds, Rb^Gvs, Gg^Fds, Gg^Fds, Gg^Fds
Gg^Fds, Gg^Fds, Gg^Fds, Ww, Gg^Fds, Ww, Gg^Fds, Gg^Fds, Gg, Gg^Efm, Gg^Fds, Gg^Fds, Wwr, Hh^Fds, Hh^Fds, Hh^Fds, Hh, Gg^Fds, Gg, Gg^Fds, Gg, Re, Hh, Hh, Hh, Hh, Hh, Hh^Fms, Hh, Gg^Fds, Re, Re, Re, Re, Gs^Fds, Re, Gs^Fds, Rb^Gvs, Gs^Fds, Rb^Gvs, Rb^Gvs, Gs^Fds, Ww, Gg^Fds, Ss, Gg^Fds, Gs^Fds, Gg^Fds, Gs^Fds
Gg^Fds, Gg^Fds, Gg^Fds, Gg^Fds, Gg^Fds, Ww, Ww, Ww, Ww, Gg, Ww^Bw\, Ww, Gg^Fds, Hh^Fds, Gg^Fds, Gg^Fds, Rb^Gvs, Rb^Gvs, Rb^Gvs, Gg^Fds, Gg^Fds, Re, Re, Hh, Re, Hh, Re, Hh, Re, Re, Re, Ce, Re, Gs^Fds, Gs^Fds, Gs^Fds, Gs^Fds, Gs^Fds, Gs^Fds, Gs^Fds, Gs^Fds, Gs^Fds, Ss, Ww, Ww, Ss, Gs^Em, Gs^Fds, Gs^Fds
Gg^Fds, Gg^Fds, Gg^Fds, Gg^Fds, Gg^Fds, Gg^Fds, Gg^Fds, Gg^Fds, Gg^Fds, Ww^Ewf, Gg, Re, Re, Gg^Fds, Re, Rb^Gvs, Gs^Vl, Rb^Gvs, Rb^Gvs, Gg^Fds, Gg^Fds, Re, Gs^Fds, Re, Re, Re, Gs^Fds, Re, Gs^Fds, Gs^Fds, Gs^Fds, Re, Re, Gs^Fds, Gs^Fds, Gs^Fds, Gs^Fds, Gs^Fds, Gs^Fds, Gs^Fds, Gg^Fds, Gs^Fds, Gs^Fds, Gs^Emf, Ss, Ss, Ss, Gs^Fds, Gs^Fds
Gg^Fds, Gg^Fds, Gg^Fds, Gg^Fds, Gg^Fds, Gg^Fds, Gg^Fds, Gg^Fds, Gg, Gg, Gg^Fds, Gg^Fds, Rb^Gvs, Re, Rb^Gvs, Re, Re, Rb^Gvs, Re, Re, Re, Re, Hh^Fds, Gs^Fds, Gs^Fds, Gs^Fds, Gs^Fds, Gs^Fds, Gs^Fds, Gs^Fds, Gg, Gg, Re, Gs^Fds, Gs^Fds, Gs^Vl, Gs^Fds, Gs^Fds, Gs^Fds, Gs^Fds, Gs^Fds, Gs^Fds, Gs^Fds, Gs^Fds, Gs^Fds, Gs^Fds, Gs^Fds, Gs^Fds, Gs^Fds
Gg^Fds, Gg^Fds, Gg^Fds, Gg^Fds, Gg^Fds, Gg^Fds, Rb^Gvs, Rb^Gvs, Rb^Gvs, Gg^Fds, Gg^Fds, Gg^Fds, Rb^Gvs, Rb^Gvs, Re, Re, Re, Re, Rb^Gvs, Rb^Gvs, Rb^Gvs, Hh, Hh, Gs^Fds, Hh^Fds, Hh^Fds, Wwr, Gs^Fds, Gs^Fds, Gs^Fds, Gs^Fds, Gg^Eff, Gg^Eff, Re, Re, Re, Re, Gs^Fds, Ww, Gs^Fds, Ww, Gs^Fds, Gs^Fds, Gs^Fds, Gs^Fds, Gs^Fds, Gs^Fds, Gs^Fds, Gs^Fds
Gg^Fds, Gg^Fds, Gg^Fds, Gg^Fds, Rb^Gvs, Rb^Gvs, Rb^Gvs, Rb^Gvs, Rb^Gvs, Gg^Fds, Gg^Fds, Gg^Fds, Gg^Fds, Rb^Gvs, Re, Ce, Re, Rb^Gvs, Rb^Gvs, Rb^Gvs, Hh^Fds, Hh^Fds, Hh^Fds, Hh^Fds, Wwr, Hh, Ww, Ww, Ww, Ww, Ww, Gg, Gg^Efm, Gg, Ww, Ww, Ww^Bw|, Ww, Wo, Wo, Wo, Wo, Wo, Gs^Fds, Ww, Ce, Gs^Fds, Gs^Fds, Ww
Gg^Fds, Gg^Fds, Gg^Fds, Gg^Fds, Rb^Gvs, Rb^Gvs, Gs^Vl, Rb^Gvs, Rb^Gvs, Rb^Gvs, Re, Re, Re, Re, Gg, Re, Gg, Re, Gg^Eff, Gs^Fds, Gs^Fds, Hh^Fds, Hh^Fds, Hh, Hh^Fds, Ww, Gs^Fds, Gs^Fds, Gs^Fds, Gs^Fds, Ww, Gg, Gg, Gg, Ww, Ww, Re, Ww^Ewl, Gs^Fds, Ww, Gs^Fds, Ww, Ww, Wo, Ww, Ww, Ww, Ww, Ww
Gg^Fds, Gg^Fds, Gg^Fds, Gg^Fds, Gg^Fds, Rb^Gvs, Gg^Fds, Rb^Gvs, Rb^Gvs, Re, Gg, Gs^Fds, Gs^Fds, Gg, Gs^Fds, Gg, Gs^Fds, Re, Re, Gg^Eff, Gs^Fds, Gs^Fds, Gs^Fds, Gs^Fds, Gs^Fds, Gs^Fds, Gs^Fds, Gs^Fds, Gs^Fds, Gs^Fds, Gs^Fds, Ww, Ww, Ww, Wo, Ww, Re, Gs^Fds, Gs^Fds, Gs^Fds, Gs^Fds, Gs^Fds, Gs^Fds, Ww, Gs^Fds, Ww, Ww, Ww, Gs^Fds
Gg^Fds, Gg^Fds, Gg^Fds, Gg^Fds, Gg^Fds, Gg^Fds, Gg^Fds, Gg^Fds, Re, Re, Gs^Fds, Gs^Fds, Gs^Fds, Gs^Fds, Gs^Fds, Gs^Fds, Gs^Fds, Gg^Efm, Gs^Fds, Re, Re, Gg, Re, Re, Re, Re, Re, Gs^Fds, Re, Gs^Vl, Gs^Fds, Gs^Fds, Ww, Wo, Ww, Gs^Fds, Gs^Fds, Re, Gs^Vl, Gs^Fds, Re, Gs^Fds, Gs, Gs^Fds, Gs^Fds, Gs^Fds, Gs^Fds, Gs^Fds, Gs^Fds
Gd^Fds, Gd^Fds, Gd^Fds, Gg^Fds, Gg^Fds, Gg^Fds, Re, Re, Ket, Re, Re, Gs^Fds, Gs^Fds, Gs^Fds, Gs^Fds, Gs^Fds, Gs^Fds, Gs^Fds, Gs^Fds, Gg, Gd^Fds, Re, Re, Re, Ket, Re, Re, Re, Gs^Eff, Re, Re, Gs, Ww, Wo, Gs^Fds, Gs^Fds, Gs^Fds, Re, Re, Re, Ket, Re, Re, Gs, Gs, Gs^Fds, Gs^Fds, Gs^Fds, Gs^Fds
Gg, Gd^Fds, Gd^Fds, Gd^Fds, Gg, Re, Ce^Ebn, Ce, Ce, Ce^Edt, Ce^Ebn, Re, Gg, Gg^Efm, Gs^Fds, Gs^Fds, Gd^Fds, Gd^Fds, Gd^Fds, Gd^Fds, Gd^Fds, Re, Ce^Ebn, Ce, Cvr, Ce^Edt, Ce^Ebn, Re, Gs, Gs^Eff, Gs, Re, Ww^Bw\, Ww, Gs, Gs^Fds, Gs, Re, Ce^Ebn, Ce, Cvr, Ce, Ce^Ebn, Re, Gs^Fds, Gs^Fds, Gs^Fds, Gs^Fds, Gs^Fds
Gg, Gd^Fds, Gd^Fds, Gg, Gg, Re, Ce^Edt, Ce^Vl, 6 Ket, Ce^Vl, Ce, Re, Gs, Gg, Gg, Gs^Fds, Gd^Fds, Gd^Fds, Gg, Gg, Gs, Re, Ce, Ce^Vl, 5 Ket, Ce^Vl, Ce, Re, Gs, Gs, Ww, Ww, Ww, Ww^Bw\, Re, Gs, Gs, Re, Ce, Ce^Vl, 4 Ket, Ce^Vl, Ce, Re, Gs^Fds, Gs^Fds, Gs^Fds, Gs^Fds, Gs^Fds
Gs, Gg, Gs, Gs, Gs, Re, Ce^Ebn, Ce^Vl, Ce, Ce^Vl, Ce^Ebn, Re, Re, Gs, Gs, Gd^Fds, Re, Gd^Fds, Gs, Gs, Re, Re, Ce^Ebn, Ce^Vl, Ce, Ce^Vl, Ce^Ebn, Re, Gs, Ww, Wo, Wo, Gs, Gs, Gs, Re, Re, Re, Ce^Ebn, Ce^Vl, Cvr, Ce^Vl, Ce^Ebn, Re, Gs, Gs^Fds, Gs^Fds, Gs^Fds, Gs^Fds
Gs, Gs, Gs, Gs, Ce, Re, Re, Ket, Ce^Ebn, Ket, Re, Re, Ce, Re, Re, Re, Ce, Re, Re, Re, Ce, Re, Re, Ket, Ce^Ebn, Ket, Re, Re, Ce, Ww, Ww, Gs, Ce, Gs, Re, Re, Ce, Re, Re, Ket, Ce^Ebn, Ket, Re, Re, Ce, Gs, Gs^Fds, Gs^Fds, Gs^Fds
Gs^Fds, Gs, Gs, Gs, Gs, Re^Bw\, Ce, Re, Re, Re, Ce, Gs^Bw/, Gs, Gs, Gs, Gs, Gs, Gs, Gs, Gs, Gs, Re^Bw\, Ce, Re, Re, Re, Ce, Re^Bw/, Wo, Ww, Ww, Gs, Gs, Re, Gs^Eff, Gs, Gs, Re^Bw\, Ce, Re, Re, Re, Ce, Re^Bw/, Gs, Gs, Gg, Gs^Fds, Gs^Fds
Ww, Ww, Wo, Ww, Ww, Ww, Ww, Wwf, Wwf, Wwf, Ww, Ww, Ww, Ww, Wo, Gs, Ww, Gs, Ww, Gs, Ww, Ww, Ww, Wwf, Wwf, Wwf, Ww, Wo, Wo, Wo, Gd^Fds, Gd^Fds, Re^Gvs, Re^Vl, Re^Gvs, Gs^Eff, Gs^Eff, Gs, Gs, Gs, Gs, Re, Re, Gs, Gd^Fds, Gs, Gs, Gs^Fds, Gs^Fds
Ww, Ww, Ww, Wo, Ww, Ww, Ww, Wwf, Wwf, Wwf, Ww, Ww, Ww, Wo, Ww, Wo, Wo, Wo, Wo, Wo, Ww, Ww, Ww, Wwf, Wwf, Wwf, Ww, Ww, Ww, Gs^Eff, Gs^Eff, Re^Gvs, Re^Gvs, Re^Gvs, Gs^Eff, Gs^Eff, Gs, Gs, Gs, Gs, Re^Gvs, Re^Gvs, Re^Gvs, Gs^Fds, Gd^Fds, Gd^Fds, Gs, Gs, Ww
Gd, Gd, Gd, Gd, Gd, Gd, Gd, Gd, Re, Gd, Gd, Gd, Gs, Gs, Gs, Ww, Gs, Ww, Gs, Ww, Gs, Gs, Gs, Gd, Re, Gd, Gd, Gd, Gs, Wwf^Es, Wwf^Es, Gs^Eff, Gs^Eff, Gs^Eff, Ww, Gs, Gs, Gs, Gs, Gs^Eff, Gs^Eff, Gs^Vl, Gs^Eff, Gs^Eff, Gd^Fds, Gd^Fds, Ww, Ww, Gd
Gd, Gd, Gd, Gd, Gd^Edb, Gd, Gd, Gd, Re, Gd, Gd^Edb, Gs^Vc, Gs^Edb, Gs, Gs, Gs^Efm, Gs, Gs, Gs, Gs, Gs^Efm, Gs^Efm, Gs, Gd, Re, Gd, Gd, Gs, Gs, Gs, Wwf^Es, Gs, Ww, Ww, Gd, Wwf^Es, Wwf^Es, Wwf^Es, Ww, Ww, Wwf^Es, Gs, Wwf^Es, Gd^Fds, Gd^Fds, Gs, Ww, Gd, Gd
Hhd, Gd, Gd, Gs^Vc, Gd^Edb, Gd^Edb, Gd, Gd, Re, Gd, Gd, Gd^Edb, Gd, Gs, Gd, Gs, Hhd, Gs, Hhd, Gs, Gs, Gs^Efm, Gs, Gs, Gd, Re, Gd, Gs, Gs, Gs, Gs, Ww, Gd, Gd, Gd, Gd, Gd, Gd, Gd, Gd, Gd, Wwf^Es, Gd, Ww, Ww, Ww, Gd, Gd, Gd
Hhd, Gd, Hhd, Gd, Hhd, Gd, Gd, Gd, Gd, Re, Re, Gd^Edb, Gd, Gs^Efm, Gd, Hhd, Rd, Hhd, Rd, Gd, Gs, Gs, Gs^Edb, Gd^Edb, Gd, Re, Gd, Gd, Gs, Gs^Efm, Gs, Gs, Gs, Gd, Gs^Vc, Gd, Gd, Gd, Gd, Gd, Gd, Gd, Gd, Gd, Gd, Gd, Gd, Gs, Gs
Hhd, Hhd, Hhd, Hhd, Hhd, Gd, Hhd, Gd, Gd, Gd, Re, Gd, Gd, Gs, Gd, Rd, Rd, Rd, Gd, Gd, Gd, Gd, Gd, Gs^Vc, Gd, Re, Gd, Gd, Gd, Gs, Gs^Efm, Gs^Efm, Gs, Gd^Edb, Gd^Edb, Gd^Edb, Gd, Gd, Gs, Gd, Gs, Gd, Gs, Gd, Gs, Gd, Gs, Gs, Gs
Hhd, Hhd, Rd, Gd, Gd, Gd, Rd, Rd, Gd, Gd, Re, Gd, Gd, Gd, Gd, Gd, Gs, Gs, Gs^Efm, Gs, Gs, Gs, Gd, Gd, Gd, Re, Re, Gd, Gd, Gs, Gs, Gs, Gs, Gs, Gs, Gd^Edb, Gd, Gs, Gd, Gs^Efm, Gs, Gs, Gs^Efm, Gs^Efm, Gs^Efm, Gs, Gs, Gs^Efm, Gs
Hhd, Hhd, Rd, Hhd, Gd, Gd, Rd, Rd, Gd, Gd, Re, Gd, Gd, Gd, Gd, Gs, Gs, Gs^Efm, Gs, Gs, Gd, Gd, Gd, Gd, Gd^Edb, Gd^Edb, Gd, Re, Re, Gd, Gs, Gs^Efm, Gs, Gd, Gd, Gd, Gd, Gd, Gd, Gd, Gd, Gd, Gd, Gs, Gd, Gs, Gs, Gs, Gd
Hhd, Hhd, Hhd, Rd, Re^Vct, Re^Vct, Ce, Ce, Ce, Re, Re, Re, Ce, Gd, Re, Gd, Gd, Gd, Gd, Gd, Hhd, Hhd, Rd, Gd^Edb, Gs^Vc, Gd^Edb, Gd^Edb, Gd, Re, Gd, Gd, Gs, Hhd, Gd, Gd, Gd, Gd, Gd, Cer, Cer, Cer, Re, Re^Ecf, Gd, Gd, Gd, Gd, Gd, Gd
Hhd, Hhd, Hhd, Rd, Rd, Re^Vct, Ce, 2 Ke, Ce, Re, Re, Ce, 1 Ke, Ce, Re^Vct, Re^Vct, Gd, Gd, Hhd, Rd, Rd, Rd, Rd, Gd, Gd, Gd, Gd, Gd, Re, Gd, Gd, Gd, Hhd, Gd, Gd, Gd, Gd, Gd, Cer, 3 Ke, Cer, Rb, Re^Vct, Re^Vct, Gd, Gd, Gd, Gd, Gd
Hhd, Hhd, Hhd, Hhd, Rd, Gd, Gd, Ce, Gd, Re, Re, Ce, Ce, Ce, Gd, Re^Vct, Gd, Gd, Hhd, Hhd, Rd, Hhd, Hhd, Hhd, Hhd, Gd, Gd, Gd, Gd, Re, Gd, Gd, Gd, Hhd, Hhd, Gd, Gd, Gd, Re, Cer, Rb, Rb, Re^Ecf, Gd, Gd, Gd, Gs, Gd, Gs
Hhd, Hhd, Hhd, Rd, Hhd, Rd, Rd, Gd, Re, Re, Rd, Rd, Rd, Rd, Hhd, Gd, Hhd, Hhd, Hhd, Hhd, Hhd, Hhd, Hhd, Hhd, Hhd, Hhd, Gd, Gd, Gd, Re, Re, Gd, Gd, Hhd, Hhd, Gd, Gd, Gd^Gvs, Gd, Rb, Gd, Re, Re, Re, Gd, Gd, Gs, Gs^Efm, Gs
Hhd, Hhd, Hhd, Hhd, Hhd, Hhd, Gd, Gd, Re, Re, Rd, Rd, Gd, Hhd, Gd, Hhd, Gd, Hhd, Gd, Hhd, Gd, Hhd, Gd, Hhd, Hhd, Hhd, Hhd, Hhd, Gd, Gd, Re, Gd, Gd, Hhd, Hhd, Hhd, Hhd, Gd, Gd, Gd, Gd, Gd, Re, Gd, Gd, Gd, Gs, Gs, Gd
