Gs^Fms, Gs, Gs^Fms, Gs^Fms, Wwf, Gg, Wwf, Gg, Gs^Fms, Gs^Fms, Gg^Efm, Gs, Gs^Fms, Hh^Fms, Hh^Fms, Hh^Fms, Hh^Fms, Gs, Re, Re, Gs, Gs, Hh^Fms, Gs, Hh^Fms, Hh^Fms, Gg, Gg, Wwg, Wwg, Gs^Fms, Gs^Fms, Gs^Fms, Gs^Fms, Gs^Fms
Gs^Fms, Gs^Fms, Gs^Fms, Gs^Fms, Gs^Fms, Wwf, Wwf, Wwf, Gs^Fms, Gs^Fms, Gg^Efm, Gs^Fms, Gs^Fms, Hh^Fms, Rb^Gvs, Gg, Gs, Ce, Re, Ce, Re, Hh^Fms, Hh^Fms, Hh^Fms, Hh^Fds, Hh^Fds, Gg, Gg, Wwg, Wwg, Gs^Fms, Gs^Fms, Gs^Fms, Gs^Fms, Gs^Fms
Gs^Fms, Gs^Fms, Gs^Fms, Gs^Fms, Gs^Fms, Gs^Fms, Gs^Fms, Wwf, Wwf, Gs^Fms, Gs^Fms, Gg, Gg, Gs^Fms, Rb^Gvs, Re^Vl, Re, Re, Re, Gs, Gs, Gg^Efm, Hh^Fds, Hh^Fds, Hh^Fds, Hh^Fds, Gg, Gg, Wwg, Wwg, Gs^Fms, Gs^Fms, Gs^Fms, Gs^Fms, Gs^Fms
Gs^Fms, Gs^Fms, Gs^Fms, Gs^Fms, Gs^Fms, Gs^Fms, Gg, Wwf, Wwf, Gs^Fms, Gs^Fms, Gs, Rb^Gvs, Gs, Gs, Gs, Ce, Ce, Ce, Re, Re^Vl, Rb^Gvs, Rb^Gvs, Rb^Gvs, Gg^Efm, Gg^Efm, Gs, Wwg, Wwg, Gs^Fms, Gs^Fms, Gs^Fms, Gs^Fms, Gs^Fms, Gs^Fms
Gs^Fms, Gs^Fms, Gs^Fms, Gs^Fms, Gs^Fms, Gs^Fms, Gg^Efm, Gg, Wwf, Gs, Gs, Rb^Gvs, Rb^Gvs, Rb^Gvs, Re^Vl, Re, Ce, 5 Ket^Vl, Ce, Re, Gs, Rb^Gvs, Rb^Gvs, Rb^Gvs, Gs, Gs, Gs, Wwg, Wwg, Gs^Fms, Gs^Fms, Gs^Fms, Gs^Fms, Gs^Fms, Gs^Fms
Gs^Fms, Gs^Fms, Gs^Fms, Gs^Fms, Gs^Fms, Gg^Efm, Gs^Fms, Gg, Wwf, Gs, Gs, Rb^Gvs, Rb^Gvs, Rb^Gvs, Rb^Gvs, Re, Re, Ce, Re, Re, Gs, Rb^Gvs, Gs, Gs, Ce, Gs, Wwg, Wwg, Wwf, Gs^Fms, Gs^Fms, Gs^Fms, Gs^Fms, Gs^Fms, Gs^Fms
Gs^Fms, Gs^Fms, Gs^Fms, Gs^Fms, Gs^Fms, Gs^Fms, Gs^Fms, Gg, Gg, Wwf, Ce, Gs, Gs, Gs, Gs, Gs, Gs^Vl, Re, Gs, Re^Vl, Gs, Gs, Gs, Gs, Gs, Gs, Wwg, Wwg, Wwf, Gs^Fms, Gs^Fms, Gs^Fms, Gs^Fms, Gs^Fms, Gs^Fms
Gs^Fms, Gs^Fms, Gs^Fms, Gs^Fms, Gs^Fms, Gs^Fms, Gg, Gg, Wwf, Wwf, Wwf, Gs, Ce, Gs, Gs, Gs, Re, Re, Gs, Gs, Ce, Gs, Ce, Gs, Wwg, Wwg, Wwg, Gs, Gs, Wwf, Wwf, Gs^Fms, Wwf, Gs^Fms, Wwf
Wwf, Gs^Fms, Wwf, Gs^Fms, Wwf, Wwf, Wwf, Wwf, Gg^Efm, Wwf, Gg^Efm, Wwf, Wwf, Gs, Wwf, Ce, Re, Ce, Wwg, Gs, Wwg, Gs, Wwg, Wwg, Wwg, Wwg, Gs, Gs, Gg, Gs, Gg^Efm, Wwf, Gs, Wwf, Gs
Gs^Fms, Wwf, Gll, Wwf, Gll, Gs, Gll, Gs, Gs, Gg^Efm, Gs, Gg^Efm, Gg, Wwf, Gg, Wwf, Wwf^Bw|, Wwg, Wwf, Wwg, Wwg, Wwg, Gg^Efm, Wwg, Gs, Gs, Gg, Gg^Efm, Hh^Fms, Gg^Efm, Gg^Efm, Gg, Gg^Efm, Gg^Efm, Hh^Fms
Gs^Fms, Gs^Fms, Gs^Fms, Gll^Em, Gs^Fms, Gll, Gs^Fms, Gll^Em, Gll^Em, Gs, Gll, Gs, Gs^Efm, Gg, Gs, Gg, Re, Gg, Gg, Gg, Gg^Efm, Wwf, Wwf, Gg^Efm, Gg^Efm, Gg^Efm, Hh^Fms, Hh^Fms, Hh^Fms, Hh^Fms, Hh^Fms, Hh^Fms, Hh^Fms, Hh^Fms, Hh^Fms
Gs^Fms, Gs^Fms, Gs^Fms, Gs^Fms, Gs^Fms, Gs^Fms, Gs^Fms, Gs^Fms, Gs^Fms, Gs^Fms, Gll^Em, Gll, Gs, Gs, Gs, Gs^Efm, Re, Gs, Gs^Efm, Gs, Gs, Gg^Efm, Wwf, Gg^Efm, Gg, Gg^Efm, Gg, Hh^Fms, Hh^Fms, Hh^Fms, Hh^Fms, Hh^Fms, Hh^Fms, Hh^Fms, Hh^Fms
Gs^Fms, Gs^Fms, Gs^Fms, Gs^Fms, Hh^Fms, Gs^Fms, Hh^Fms, Gs^Fms, Gs^Fms, Gs^Fms, Gs^Fms, Gll, Gll, Gll, Gs, Gs, Re, Gs, Gs^Efm, Gs^Efm, Gs^Vl, Gg^Efm, Gg, Wwf, Wwf, Gs, Gs, Gg^Efm, Rb^Gvs, Gg, Gg^Eff, Gg^Efm, Gg^Efm, Gg^Efm, Gs^Efm
Gs^Fms, Gs^Fms, Gs^Fms, Gs^Fms, Hh^Fms, Hh^Fms, Hh^Fms, Hh^Fms, Hh^Fms, Gs^Fms, Gs^Fms, Gs^Fds, Gs^Fds, Gll, Gll, Ce, Re, Ce, Gs, Gs, Re, Rb^Gvs, Rb^Gvs, Gg, Wwf, Gs, Gs, Gs^Vl, Rb^Gvs, Rb^Gvs, Gg^Eff, Gg^Eff, Gg^Efm, Gg^Efm, Gg^Efm
Gs^Fms, Gs^Fms, Gs^Fms, Hh^Fms, Hh^Fms, Mm^Fms, Hh^Fms, Hh^Fms, Gs^Fms, Gs^Fms, Gs^Fds, Gs^Fds, Gs^Fds, Gll^Em, Gll, Gs, Gs, Re, Re, Gs, Re, Rb^Gvs, Gs^Eff, Gs, Wwf, Gs, Re, Re, Gg^Efm, Gg^Efm, Hh^Fms, Gg^Efm, Hh^Fms, Hh^Fms, Hh^Fms
Gs^Fms, Gs^Fms, Gs^Fms, Gs^Fms, Gs^Fms, Gs^Fms, Gs^Fms, Gs^Fms, Gs^Fms, Gs^Fms, Gs^Fms, Gs^Fds, Gs^Fds, Gll^Em, Gll, Gll, Gs, Gs^Efm, Gs^Efm, Re, Gs, Gs^Eff, Rb^Gvs, Gs, Re, Wwf^Bw/, Gs, Gs, Gg, Gg^Efm, Hh^Fms, Hh^Fms, Hh^Fms, Hh^Fms, Hh^Fms
Gs^Fms, Gs^Fms, Gs^Fms, Gs^Fms, Gs^Fms, Gs^Fms, Gs^Fms, Gs^Fms, Gs^Fms, Gs^Fms, Gs^Fms, Gs^Fds, Gs^Fds, Gs^Fds, Gll^Em, Gll, Gll, Gs^Efm, Gs^Efm, Re, Re, Rb^Gvs, Rb^Gvs, Gs^Vl, Gs, Wwf, Wwf, Gs, Gs, Gg, Gg^Efm, Hh^Fms, Hh^Fms, Hh^Fms, Hh^Fms
Gs^Fds, Gs^Fms, Gs^Fms, Gs^Fms, Gs^Fms, Gs^Fms, Gs^Fms, Gs^Fms, Gs^Fds, Gs^Fms, Gs^Fds, Gs^Fms, Gs^Fds, Gs^Fds, Gs^Fds, Gs^Fds, Gll, Gll, Gs, Gs, Gs, Re, Re, Re, Gs^Fds, Gs, Gs^Fms, Wwf, Wwf, Gs, Gs, Gg^Efm, Gg^Efm, Hh^Fms, Gg
Gs^Fds, Gs^Fds, Gs^Fds, Gs^Fms, Gs^Fds, Gs^Fms, Gs^Fds, Gs^Fds, Gs^Fds, Gs^Fds, Gs^Fds, Gs^Fds, Gs^Fds, Gs^Fds, Gs^Fds, Gs^Fds, Gll, Gll, Rb^Gvs, Gs, Re, Re, Gs, Gs^Efm, Gs^Fds, Gs^Fds, Gs^Fms, Gs^Fms, Gs, Wwf, Gs, Gs, Re, Gg, Re
Gll, Gs^Fds, Gll^Em, Gs^Fds, Gs^Fds, Gs^Fds, Gs^Fds, Gs^Fds, Gll^Em, Gs^Fds, Gll^Em, Gs^Fds, Gll, Gs^Fds, Gll^Em, Gll^Em, Gll^Eff, Rb^Gvs, Rb^Gvs, Gs^Vl, Gs, Re, Gs, Gs^Efm, Gs, Gs^Efm, Gs, Gs, Wwf, Wwf, Gs, Re, Gg, Re, Gg
Gs, Gll, Gll, Gll, Gll, Gs^Fms, Gll, Gs^Fds, Gll, Gll, Gll, Gll, Gd^Gvs, Gll, Gd^Gvs, Gll, Gd^Gvs, Gs^Eff, Gs, Re, Re, Re, Re, Re, Re, Re, Re, Wwf, Re, Gs, Re, Re, Gs, Gg^Efm, Gg^Fms
Wwf, Gs, Gs, Gs^Gvs, Gd, Gll, Gll^Gvs, Gll, Gs, Gs^Gvs, Gs, Gs, Gs, Gd^Gvs, Gs, Gd^Gvs, Gs, Gs, Re, Re, Gs, Gs, Gs^Fds, Gs^Fms, Gs^Fms, Gs^Fms, Gs, Wwf, Wwf, Re, Gg^Efm, Re, Re, Gs, Gs
Gs, Wwf, Gs, Gs, Gs, Gs^Gvs, Gs, Gs^Gvs, Gs, Gs, Wwf, Gs, Gs, Gs, Gs, Gs, Re, Re, Gs^Fds, Gs^Fds, Gs^Efm, Gs^Fds, Gs^Fds, Gs^Fds, Gs^Fms, Gs^Fms, Wwf, Wwf, Gs, Gs, Gs, Gs, Re, Gs, Gs
Gs, Wwf, Wwf, Gs, Wwf, Gs, Wwf, Gs, Wwf, Wwf, Gs, Wwf, Wwf, Wwf, Wwf, Re, Gs, Gs^Efm, Gs, Gs^Fds, Gs, Gs, Wwf, Wwf, Wwf, Wwf, Ce, Wwf, Ce, Gs, Gs, Gs^Vl, Re, Gs, Gs
Gg, Gs, Gs, Wwf, Gs, Wwf, Gs, Wwf, Gs, Gs, Gs^Vl, Gs, Gs^Gvs, Gs, Gs, Wwf^Bw|, Wwf, Gs, Wwf, Gs, Wwf, Wwf, Gs, Gs, Ce, Gs, Gs, Gs, Gs, Gs, Gs, Gs, Re, Gs, Gs
Hh^Fds, Gg^Gvs, Gg^Gvs, Gs, Gg, Gs, Gg^Efm, Gg^Efm, Gg^Efm, Rb^Gvs, Rb^Gvs, Rb^Gvs, Re, Re, Ce, Re, Ce, Wwf, Gs, Wwf, Wwf, Gs, Gs, Gs, Gs, Gs, Gs, Gs^Vl, Gs, Gs, Gs, Re, Gs, Re, Re
Hh^Fds, Hh^Fds, Hh^Fds, Gg^Fds, Hh^Fds, Gg^Efm, Hh^Fds, Gs^Efm, Hh^Fds, Gg^Fds, Gg^Fds, Gg^Fds, Gg^Gvs, Gg, Gs^Gvs, Re, Gs^Gvs, Gs, Gs^Vl, Gs, Ce, Wwf, Gs, Gs, Re, Gs, Re, Gs, Ce, 4 Ke, Ce, Re, Gs, Gs^Vl, Gs
Hh^Fds, Hh^Fds, Hh^Fms, Hh^Fms, Hh^Fms, Hh^Fms, Hh^Fds, Hh^Fds, Hh^Fds, Gg^Fds, Gs, Gs, Gs, Gs^Gvs, Gs, Re, Re, Re, Rb^Gvs, Rb^Gvs, Rb^Gvs, Wwf, Wwf^Bw/, Re, Gs^Vl, Re, Gs, Re, Re, Ce, Re, Re, Gs, Gs, Gg
Hh^Fds, Hh^Fds, Hh^Fds, Hh^Fds, Hh^Fds, Hh^Fds, Gs^Fds, Hh^Fds, Re, Re, Re, Re, Gs, Gs^Vl, Gs, Gs, Re, Gs, Gs, Rb^Gvs, Gs, Gs, Wwf, Gs, Gs, Gs, Gs, Gs, Wwf, Re, Wwf, Gs, Ce, Gg^Efm, Gg
Gs, Hh^Fds, Gs, Hh^Fds, Gs, Gs^Fds, Gg^Fds, Gs, Rb^Gvs, Gs^Vl, Rb^Gvs, Gs, Gs, Gs^Gvs, Gs, Gs, Ce, 3 Ke, Ce, Gs, Gs, Gs, Gs, Wwf, Wwf, Wwf, Wwf, Wwf, Ce, Wwf, Ce, Wwf, Wwf, Gs, Gs
Gg^Efm, Gg^Efm, Gg^Efm, Gg^Efm, Gg^Efm, Gg^Efm, Gg, Gg, Gg, Rb^Gvs, Gs, Gs, Gs^Gvs, Gs, Gs^Gvs, Gs^Gvs, Gs, Ce, Gs, Gs, Rb^Gvs, Gg, Gg, Gs, Ce, Gs, Gs, Gs, Re, Re, Gg, Gs, Gs, Wwf, Wwf
Gg^Efm, Gg^Efm, Gg^Efm, Gg^Efm, Gs^Fds, Gs, Hh^Fds, Gs, Hh^Fds, Gs, Hh^Fds, Hh^Fds, Hh^Fms, Ce, Hh^Fds, Gs^Gvs, Gs, Re, Re, Rb^Gvs, Rb^Gvs, Ce, Gg^Fms, Gg^Efm, Gg^Efm, Gg, Hh^Fds, Gg^Efm, Gg^Fds, Gg^Efm, Gg^Efm, Gg, Gg, Wwf, Gs
Gg, Gg^Efm, Gs, Gs^Fds, Hh^Fds, Hh^Fds, Hh^Fds, Hh^Fds, Hh^Fms, Hh^Fms, Hh^Fms, Hh^Fms, Hh^Fms, Hh^Fds, Hh^Fds, Hh^Fds, Ce, Re, Ce, Gs^Vl, Gg, Gs^Fms, Hh^Fds, Gg^Fds, Hh^Fds, Hh^Fds, Gg^Efm, Gg^Efm, Gg^Efm, Hh^Fds, Hh^Fms, Hh^Fds, Hh^Fds, Gg, Gs^Fds
Gg, Gg, Gs^Fds, Hh^Fds, Gs^Fds, Hh^Fds, Hh^Fds, Hh^Fds, Hh^Fds, Hh^Fds, Hh^Fds, Hh^Fds, Gs^Fds, Hh^Fds, Gs^Gvs, Gs^Gvs, Re, Re, Gs, Gg, Gg, Gg^Fds, Gg^Efm, Hh^Fds, Gg, Hh^Fds, Gg^Fds, Gg^Efm, Re, Hh^Fms, Hh^Fms, Hh^Fms, Hh^Fds, Hh^Fds, Hh^Fds
Gg^Efm, Gg, Gg, Gs^Fds, Gs^Vl, Gs, Gs, Hh^Fds, Gs, Hh^Fds, Gs^Efm, Gs, Gg, Gs, Gs, Gs, Re, Gs, Gs^Gvs, Gs^Gvs, Hh^Fds, Gs, Gg, Gg, Gg^Efm, Gg, Gg, Gg^Efm, Re, Gg, Gs^Fds, Hh^Fds, Hh^Fds, Hh^Fds, Gs
Gg^Efm, Gg^Efm, Gg^Efm, Gg^Efm, Gg^Efm, Gg, Gg^Fds, Gs, Gs^Fms, Gs, Gs^Fms, Gg, Gs, Gs, Gs, Re, Gs, Gs, Gs, Gs, Hh^Fds, Gs^Fms, Gs^Fms, Gs^Fms, Hh^Fds, Hh^Fds, Hh^Fds, Gg^Efm, Gg^Efm, Gg, Gs^Vl, Gs, Gs, Gs, Gg
Gg^Efm, Gg^Efm, Gg^Efm, Gg^Efm, Gs^Fms, Gg^Fds, Gg^Fds, Gg^Fds, Gs^Fms, Gg^Fds, Gs, Gg, Gs, Gs, Gs, Re, Gs^Gvs, Gs^Gvs, Gs, Hh^Fds, Hh^Fds, Hh^Fds, Gs^Fds, Hh^Fds, Hh^Fds, Hh^Fds, Gg^Efm, Hh^Fds, Gg^Efm, Gg^Efm, Gg^Efm, Gg^Efm, Gg^Efm, Gg^Efm, Gg
Gg, Gg, Gs, Gs, Gs, Gs, Gs, Gs, Gs, Gs, Gs^Gvs, Gs, Gs^Gvs, Gs, Gs, Re, Re, Gs^Gvs, Gs, Gg, Gg, Gs, Rb^Gvs, Rb^Gvs, Rb^Gvs, Gg, Gg, Re, Gs, Gg^Efm, Gs, Gg, Gs, Gg, Gs
Gs^Fds, Gs^Fds, Hh^Fds, Hh^Fds, Hh^Fds, Gs^Fds, Hh^Fds, Hh^Fds, Hh^Fds, Hh^Fds, Hh^Fds, Gs^Gvs, Hh^Fds, Gs^Gvs, Gs, Gs, Gs, Re, Re, Gs, Re, Gs^Vl, Gs^Gvs, Rb^Gvs, Re, Re, Hh^Fds, Gs, Hh^Fds, Gs, Hh^Fds, Hh^Fds, Hh^Fms, Hh^Fds, Hh^Fds
Hh^Fds, Hh^Fds, Hh^Fds, Hh^Fds, Hh^Fms, Hh^Fds, Hh^Fms, Hh^Fms, Hh^Fds, Hh^Fds, Hh^Fds, Hh^Fds, Gg^Efm, Gs, Gg, Gs^Gvs, Gs, Gs, Gs, Re, Re, Gs, Re, Gg, Re, Hh^Fds, Hh^Fds, Hh^Fds, Hh^Fds, Hh^Fds, Hh^Fds, Hh^Fds, Hh^Fds, Hh^Fds, Hh^Fds
Hh^Fds, Hh^Fds, Hh^Fms, Hh^Fms, Hh^Fms, Hh^Fms, Hh^Fds, Hh^Fds, Hh^Fds, Hh^Fds, Hh^Fds, Gg^Fds, Gg^Efm, Gg^Efm, Gs, Gs, Ce, Ce, Ce, Gs, Re, Re, Ce, Ce, Ce, Gs, Gs^Gvs, Gs^Fds, Gs, Gs^Fds, Gs, Hh^Fds, Hh^Fds, Hh^Fds, Hh^Fds
Gs^Fds, Hh^Fds, Hh^Fds, Hh^Fms, Hh^Fds, Hh^Fds, Hh^Fds, Hh^Fds, Gs, Gs^Gvs, Gg, Gg, Gg, Gg, Gs, Gs, Ce, 1 Ke, Ce, Re, Re, Re, Ce, 2 Ke, Ce, Gs, Gg, Gg, Gg^Efm, Gs^Efm, Gg^Efm, Gs, Gs^Efm, Gs, Gs
Gg, Gg^Fds, Gg^Efm, Hh^Fds, Gs^Efm, Gs^Efm, Gg^Efm, Gs, Gg^Efm, Gg, Gg, Gg, Gs^Gvs, Gs, Gs, Gs, Re, Ce, Re, Re, Re, Re, Re, Ce, Re, Gs, Gs, Gg, Gg, Gg^Efm, Gg^Efm, Gg^Efm, Gg^Efm, Gg^Efm, Gg
Gg^Efm, Gg^Efm, Gg^Efm, Gg^Efm, Gg^Efm, Gg^Efm, Gg, Gg^Efm, Gg, Gg, Gs, Gs^Gvs, Gs^Gvs, Gs, Gs^Gvs, Gs, Gs, Re, Gs, Gs, Re, Gs, Gs, Re, Gs, Gs, Gs, Gs, Gs, Gg, Gg, Gg, Gg, Gg, Gg
Gs, Gg, Gs, Gg, Gs, Gg, Gs, Gg, Gs, Gs, Gs, Gs, Gs, Gs, Gs, Gs, Gs, Gs, Gs, Gs, Gs, Re, Gs, Gs, Gs, Gs, Gs, Gs, Gs, Gs, Gs, Gg, Gg, Gg, Gs
