Ss, Ss, Ss, Gg, Gll^Fp, Ww, Ww, Gs^Fms, Gs^Fms, Gs^Fms, Gs^Qhhf, Gs^Fds, Gs^Qhhf, Gs^Fds, Gs^Fds, Gs^Fds, Gs^Fds, Gs, Re, Re, Gs, Gg, Gs^Fds, Gs^Qhhf, Gs^Qhhf, Gs^Qhhf, Gg, Gg, Ww, Wo, Ww, Gll^Fp, Gll^Fp, Gll^Fp, Gll^Fp
Gg, Ss, Gll^Em, Ss, Gll^Fp, Ww, Ww, Gs^Qhhf, Gs^Qhhf, Gs^Qhhf, Gg^Es, Gs^Qhhf, Gs^Qhhf, Gs^Fds, Rb^Gvs, Rb^Gvs, Rb^Gvs, Ce, Re, Ce, Gg, Gs^Fds, Gs^Qhhf, Gs^Qhhf, Gs^Fds, Gs^Qhhf, Gg^Efm, Gg, Ww, Wo, Gs^Fds, Gs^Fds, Gll^Fp, Gll^Fp, Gll^Fp
Ss, Ss, Ss, Gll^Fp, Gll^Fp, Gll^Fp, Ww, Wwr, Wwr, Gs^Qhhf, Gs^Fms, Gs^Es, Gs^Eff, Gs^Fds, Rb^Gvs, Re^Vl, Re, Re^Es, Re, Gs, Gs^Eff, Gg^Eff, Gg^Eff, Gs^Qhhf, Gs^Fds, Gs^Fds, Gg, Gg, Ww, Ww, Gll^Fp, Gs^Fds, Gll^Em, Gll^Fp, Gll^Fp
Gll^Fp, Gll^Fp, Gll^Em, Gll^Em, Gll, Gll^Fp, Gg, Ww, Ww^Es, Gs^Qhhf, Gs^Fms, Gs^Eff, Rb^Gvs, Gs^Eff, Rb^Gvs, Re, Ce, Ce, Ce, Re, Re^Vl, Rb^Gvs, Rb^Gvs, Gg^Eff, Gg, Gg^Efm, Gg, Ww, Ww, Wwr, Gs^Fds, Gll^Fp, Gll^Em, Gll^Fp, Gll^Fp
Gg, Gll^Fp, Ss, Ww, Ss, Gg^Efm, Gg, Ww, Wwf^Es, Gs, Gs, Rb^Gvs, Rb^Gvs, Rb^Gvs, Re^Vl, Re, Ce, 5 Ket^Vl, Ce, Re^Es, Rb^Gvs, Rb^Gvs, Rb^Gvs, Rb^Gvs, Gs^Eff, Gs^Fds, Gg, Ww, Ww, Gll^Fp, Gs^Fds, Gs^Fds, Gll^Fp, Gll^Fp, Gll^Fp
Gll, Gll^Em, Gll^Fp, Gll^Em, Gll^Em, Gll, Gll, Gg, Ww, Ww^Es, Gs^Fds, Gs^Eff, Gs^Eff, Rb^Gvs, Rb^Gvs, Re, Re, Ce, Re, Re, Gs^Eff, Rb^Gvs, Gs^Eff, Gs^Eff, Ce, Gs^Fds, Ww, Wo, Wwr, Gs^Fds, Gs^Fds, Gll^Em, Gll^Fp, Gll^Em, Gll^Fp
Ss, Ss, Gll^Fp, Gll^Em, Ss, Gll^Fp, Gll^Fp, Gg^Efm, Gg, Ww, Ce, Gs^Fds, Gg, Gs^Eff, Gs^Eff, Gs^Eff, Gs^Vl, Re, Gs, Re^Vl, Gg, Gs^Eff, Gg, Gg, Gs^Fds, Gg, Ww, Ww, Ww, Gll^Fp, Gs^Fds, Gs^Fds, Gll^Fp, Gll^Fp, Gll^Fp
Ss, Ww, Gll, Gll, Ww, Gll, Ss, Ss, Ww, Ww, Ww, Gg, Ce, Gg, Gg, Gs, Re, Re, Gg, Gg, Ce, Gg, Ce, Gg, Ww, Ww, Ww, Gg, Gg, Ww, Wwf, Gll^Fp, Ww, Gll^Fp, Ww
Ww, Ss, Ww, Ss, Ww, Ww, Ww, Ww, Gll^Em, Ww, Ss, Ww, Ww, Gg, Ww, Ce, Re, Ce, Ww, Gs^Fds, Ww, Gg, Ww, Ww, Wo, Ww, Wwf, Gg^Efm, Gg^Efm, Wwf, Gg, Ww, Gg, Ww, Gg
Gll^Fms, Ww, Ss, Ww, Ss, Gll^Em, Gll^Emf, Ss, Ss, Gll^Em, Gg, Gg, Gg, Ww, Gg, Ww, Ww^Bw|, Ww, Ww, Ww, Ww, Ww, Gg, Wo, Gg^Efm, Gg, Wwf, Gg^Efm, Gs^Fds, Wwf, Wwf, Gg^Efm, Gg, Wwf, Gs^Fds
Gs^Fms, Gll^Fms, Gll^Fms, Ss, Gll^Fms, Gll^Em, Gll^Fms, Gll^Em, Ss, Gll, Gll, Gg, Gg, Gg, Gg^Efm, Gg, Re, Gg, Gg^Eff, Gg^Eff, Gg^Eff, Ww, Wwf, Gg^Efm, Gg^Efm, Gg, Gs^Fds, Gs^Fds, Gs^Qhhf, Gs^Fds, Gs^Fds, Gs^Qhhf, Gs^Qhhf, Gs^Fds, Gs^Fds
Gs^Fms, Gs^Fms, Gs^Qhhf, Gll^Fms, Gs^Fms, Gll^Fms, Ss, Ss, Gs^Fms, Gs^Fms, Ss, Gg, Gg, Gg^Efm, Gg^Efm, Gg, Re, Gg, Rb^Gvs, Rb^Gvs, Rb^Gvs, Gg, Ww, Gg, Wwf, Wwf, Wwf, Gs^Qhhf, Gll^Fp, Gll^Fp, Gs^Fds, Gs^Qhhf, Gs^Qhhf, Gs^Fds, Gs^Fds
Gs^Qhhf, Gs^Qhhf, Gs^Qhhf, Gs^Qhhf, Hh^Qhhf, Gs^Fms, Hh^Fms, Gs^Fms, Gs^Fms, Gs^Fms, Gs^Fms, Gll, Gg, Gg, Gg, Gg, Re, Gg, Gg, Rb^Gvs, Gs^Vl, Gg, Gg, Ww, Ww, Gg, Gg, Gg, Rb^Gvs, Rb^Gvs, Rb^Gvs, Gg^Eff, Gg^Eff, Gg^Es, Gg
Gs^Qhhf, Gs^Qhhf, Gll^Fp, Gs^Qhhf, Hh^Qhhf, Hh^Fp, Hh^Qhhf, Hh^Fp, Hh^Qhhf, Gs^Qhhf, Gs^Qhhf, Gs^Fds, Gs^Fds, Gg, Gg, Ce, Re, Ce, Gg, Gg, Re, Rb^Gvs, Rb^Gvs, Gg, Ww, Gg, Gg, Gs^Vl, Rb^Gvs, Rb^Gvs, Rb^Gvs, Rb^Gvs, Rb^Gvs, Gg^Eff, Gg
Gs^Fms, Gs^Qhhf, Gs^Es, Hh^Qhhf, Hh^Qhhf, Mm^Qhhf, Hh^Qhhf, Hh^Qhhf, Gll^Fp, Gs^Qhhf, Gs^Fds, Gs^Fds, Gs^Fds, Gg, Gs^Fds, Gg, Gg, Re, Re, Gg, Re, Rb^Gvs, Gs^Eff, Gg, Ww, Gg, Re, Re, Gs^Eff, Rb^Gvs, Gs^Fds, Rb^Gvs, Gs^Qhhf, Gs^Fds, Gll^Fp
Gs^Fms, Gs^Fms, Gs^Fms, Gs^Qhhf, Gs^Fms, Gs^Qhhf, Gs^Qhhf, Gs^Qhhf, Gs^Qhhf, Gs^Qhhf, Gs^Qhhf, Gs^Fds, Gs^Fds, Gg, Gg^Efm, Gs^Fds, Gg, Gs, Gs, Re, Gs, Gs^Eff, Rb^Gvs, Gg, Re, Ww^Bw/, Gg, Gg, Gg^Efm, Gs^Eff, Gs^Qhhf, Gs^Fds, Gs^Qhhf, Gs^Qhhf, Gs^Fds
Gs^Fms, Gs^Fms, Gs^Fms, Gs^Qhhf, Gs^Fms, Gs^Fms, Gs^Qhhf, Gs^Efm, Gs^Efm, Gs^Qhhf, Gs^Qhhf, Gs^Fds, Gs^Fds, Gs^Fds, Gg, Gg, Gg^Efm, Gs, Gs, Re, Re, Rb^Gvs, Rb^Gvs, Gs^Vl, Re, Ww, Ww, Ww, Ww, Gs, Gs, Gs^Qhhf, Gs^Qhhf, Gs^Fds, Gs^Qhhf
Gs^Fds, Gs^Fms, Gs^Fms, Gs^Fms, Gs^Fms, Gs^Fms, Gs^Fds, Gs^Fds, Gs^Fds, Gs^Fms, Gs^Fds, Gs^Fms, Gs^Fds, Gs^Fds, Gs^Fds, Gs^Fds, Gg^Efm, Gg, Gs, Gs, Gs, Re, Re, Re, Gs^Fds, Gg, Gs^Fms, Gg, Ww, Gg, Gg^Efm, Gs^Es, Gs, Gs^Qhhf, Gs
Gs^Fds, Gs^Fds, Gs^Fds, Gs^Fms, Gs^Fds, Gs^Fds, Gs^Fds, Gs^Fds, Gs^Fds, Gs^Fds, Gs^Fds, Gs^Fds, Gs^Fds, Gs^Fds, Gs^Fds, Gs^Fds, Gg, Gg, Rb^Gvs, Gs, Re, Re, Gs, Gg^Efm, Gs^Fds, Gs^Fds, Gs^Fms, Gs^Fms, Gg, Ww, Gg^Efm, Gg, Re, Gs, Re
Gg, Gs^Fds, Gg, Gs^Fds, Gs^Fds, Gs^Fds, Gs^Fds, Gs^Fds, Gg^Es, Gs^Fds, Gg, Gs^Fds, Gg^Efm, Gs^Fds, Gg, Gg, Rb^Gvs, Rb^Gvs, Rb^Gvs, Gs^Vl, Gs, Re, Gs, Gs^Efm, Gs, Gg^Efm, Gg, Gg, Ww, Ww, Gg, Re, Gs^Fds, Re, Gs^Fds
Gg, Gg^Efm, Gs^Fds, Gg^Es, Gg, Gs^Fds, Gg, Gs^Fds, Gg^Es, Gg^Es, Gs^Fds, Gg, Gg^Efm, Gg, Rb^Gvs, Rb^Gvs, Rb^Gvs, Rb^Gvs, Gg^Eff, Re, Re, Re, Re, Re, Re, Re, Re, Ww^Es, Re, Gg, Re, Re, Gg, Gs^Fds, Gs^Fds
Ww, Gg, Gg, Gs^Fds, Gs^Fds, Gs^Fds, Gg^Efm, Gg, Gg, Gs^Fds, Gg, Gg^Efm, Gg, Gg, Gg^Eff, Rb^Gvs, Gg^Eff, Gg^Eff, Re, Re, Gs, Gs, Gs^Fds, Gs^Fms, Gs^Fms, Gs^Fms, Gg, Wwf^Es, Ww, Re, Gg^Eff, Re, Re, Gs^Eff, Gs^Eff
Gs, Ww, Gg, Gs^Fds, Gs^Fds, Gs^Fds, Gg, Gs^Fds, Gg, Gg, Ww, Gg, Gg, Gg, Gg, Gg^Eff, Re, Re, Gs^Fds, Gs^Fds, Gs^Efm, Gs^Fds, Gs^Fds, Gs^Fds, Gs^Fms, Gs^Fms, Ww, Ww, Gs^Fds, Gs^Fds, Gs^Eff, Gs^Eff, Re, Rb^Gvs, Rb^Gvs
Gs, Ww, Ww, Gs^Fds, Ww, Gg, Ww, Gg, Ww, Ww, Gs, Ww, Ww, Ww, Ww, Re, Gg, Gs^Efm, Gg, Gs^Fds, Gg, Gg, Ww, Ww, Ww, Ww, Ce, Ww, Ce, Gs, Rb^Gvs, Gs^Vl, Re, Rb^Gvs, Rb^Gvs
Gg, Gs, Gs, Ww, Gs, Ww, Gs, Ww, Gs, Gs, Gs^Vl, Gs, Gs^Gvs, Gs, Gs, Ww^Bw|, Ww, Gg, Ww, Gg, Ww, Ww, Gg, Gg, Ce, Gs^Edt, Gs, Gs, Gs^Eff, Rb^Gvs, Rb^Gvs, Rb^Gvs, Rb, Rb^Gvs, Rb^Gvs
Gs^Fds, Gg^Gvs, Gg^Gvs, Gs, Gg, Gs, Gg^Efm, Gg^Efm, Gg^Efm, Rb^Gvs, Rb^Gvs, Rb^Gvs, Re, Re, Ce, Re, Ce, Ww, Gs, Ww, Ww, Gg, Gg^Eff, Gs^Eff, Rb^Gvs, Rb^Gvs, Rb^Gvs, Gs^Vl, Re, Gs^Eff, Gs, Re, Rb, Re, Re
Gs^Fds, Gs^Fds, Gs^Fds, Gg^Fds, Gs^Qhhf, Gg^Efm, Gs^Fds, Gs^Efm, Gs^Fds, Gs^Fds, Gs^Fds, Gs^Fds, Rb^Gvs, Rb^Gvs, Rb^Gvs, Re, Gs^Gvs, Gs, Gs^Vl, Gs, Ce, Ww, Gg, Gs^Eff, Re, Rb^Gvs, Rb, Re, Ce, 4 Ke, Ce, Rb, Rb^Gvs, Gs^Vl, Rb^Gvs
Gs^Fds, Gs^Fds, Gs^Fds, Gs^Qhhf, Gs^Fds, Gs^Qhhf, Gs^Qhhf, Gs^Fds, Gs^Qhhf, Gs^Fds, Rb^Gvs, Rb^Gvs, Rb^Gvs, Rb^Gvs, Re, Re, Re, Re, Rb^Gvs, Rb^Gvs, Rb^Gvs, Ww, Ww^Bw/, Re, Gs^Vl, Rb, Gs^Eff, Re, Re, Ce, Re, Re, Gs^Eff, Rb^Gvs, Rb^Gvs
Gs^Fds, Gs^Fds, Gs^Qhhf, Gs^Fds, Gll^Fp, Gs^Fds, Gs^Fds, Gs^Qhhf, Re, Re, Re, Re, Re, Gs^Vl, Gs, Gs, Re, Gs^Eff, Gs^Eff, Rb^Gvs, Gs, Gs, Ww, Gg^Eff, Gg^Eff, Gs^Eff, Gg, Gs, Ww, Re, Ww, Gs, Ce, Gs^Eff, Gs^Eff
Gs, Gll^Fp, Gs, Gs^Qhhf, Gg, Gll^Fp, Gs^Fds, Gs, Rb^Gvs, Gs^Vl, Rb^Gvs, Rb^Gvs, Rb^Gvs, Rb^Gvs, Rb^Gvs, Gs, Ce, 3 Ke, Ce, Gs, Rb^Gvs, Gs^Eff, Gs^Eff, Ww, Ww, Ww, Ww, Ww, Ce, Ww^Bw|, Ce, Ww, Ww, Gg^Edt, Gg
Gg, Gg, Gs^Fds, Gg, Gs^Qhhf, Gg, Gg, Gg^Eff, Gg^Eff, Rb^Gvs, Gs^Eff, Gs^Eff, Rb^Gvs, Rb^Gvs, Gs, Gs, Gs, Ce, Rb^Gvs, Rb^Gvs, Rb^Gvs, Rb^Gvs, Gg, Gs, Ce, Gs, Gs, Gs, Re, Re, Gg, Gs, Gs, Ww, Ww
Gs^Fds, Gg, Gs^Fds, Gs^Qhhf, Gs^Fds, Gs, Gs^Fds, Gs, Gs^Fds, Gs^Eff, Gs^Fds, Gs^Fds, Gs^Qhhf, Ce, Gs^Fds, Gs, Gs, Re, Re, Rb^Gvs, Rb^Gvs, Ce, Gs^Fds, Gg^Efm, Gg^Efm, Gg, Gs^Fds, Re, Gs^Fds, Gg^Efm, Gg^Efm, Gg, Gg, Ww, Gs
Gs^Fds, Gs^Fds, Gs^Fds, Gs^Fds, Gs^Qhhf, Gs^Fds, Gs^Qhhf, Gs^Fds, Gs^Qhhf, Gs^Qhhf, Gs^Qhhf, Gs^Qhhf, Gs^Fds, Gs^Fds, Gs^Fds, Gs^Fds, Ce, Re, Ce, Gs^Vl, Gg, Gs^Fds, Gs^Qhhf, Gs^Fds, Gs^Qhhf, Gs^Fds, Gg, Re, Gg, Gs^Fds, Gs^Fds, Gs^Fds, Gs^Qhhf, Gg, Gs^Fds
Gs^Fds, Gs^Fds, Gs^Fms, Gll^Fp, Gll^Fp, Gll^Fp, Gll^Fp, Gs^Qhhf, Gll^Fp, Gs^Fms, Gs^Fds, Gs^Qhhf, Gs^Fds, Gs^Fds, Gg, Gg, Gg, Re, Gg, Gg, Gg, Gg^Fds, Gg, Gs^Qhhf, Gg, Gs^Fds, Gg^Fds, Re, Re, Gs^Fms, Gs^Qhhf, Gs^Qhhf, Gs^Fds, Gs^Fds, Gs^Fds
Gg^Em, Gll^Fp, Gg^Em, Gll^Fp, Gs^Vl, Gg^Em, Gg, Gs^Fds, Gg, Gs^Fds, Gg^Efm, Gg, Gg, Gg, Gg, Gg, Re, Re, Gg, Gg, Gs^Fds, Gg, Gg^Efm, Gg^Efm, Gg^Efm, Gg, Gg, Gg, Re, Gg, Gs^Fds, Gs^Qhhf, Gs^Fds, Gs^Qhhf, Gs
Gg, Gg^Em, Gg, Gs, Gs, Gs, Gs^Fms, Gg, Gs^Fds, Gg, Gs^Fds, Gg^Efm, Gg, Gg, Gg, Gg, Re, Gg, Gg, Gg, Gs^Qhhf, Gs^Qhhf, Gs^Qhhf, Gs^Qhhf, Gs^Fds, Gs^Fds, Gs^Fds, Gg, Gg, Re, Gs^Vl, Gs, Gs^Eff, Gs, Gg
Gg, Gg, Gg, Gg^Em, Gll^Fp, Gll^Fp, Gll^Fp, Gs^Fds, Gs^Fds, Gs^Fds, Gg^Efm, Gg, Gg, Gg, Gg, Gg, Re, Gg, Gg, Gs^Fds, Gs^Fds, Gs^Fds, Gs^Fds, Gs^Fds, Gs^Fds, Gs^Fms, Gg, Gs^Fds, Re, Re, Rb^Gvs, Rb^Gvs, Rb^Gvs, Gg^Eff, Gg
Gg, Gs^Fds, Gg^Efm, Gg, Gg, Gg, Gg, Gg, Gg, Gg^Efm, Gg, Gg^Efm, Gg, Gg, Gg, Gg, Gg, Re, Gg, Gg, Gg^Eff, Gs^Eff, Rb^Gvs, Rb^Gvs, Rb^Gvs, Gg, Re, Re, Gg^Eff, Rb^Gvs, Rb^Gvs, Rb^Gvs, Gs, Gg, Gs
Gs^Fds, Gs^Fds, Gs^Fds, Gs^Fds, Gs^Fds, Gs^Fds, Gs^Fds, Gs^Qhhf, Gs^Qhhf, Gs^Qhhf, Gs^Fds, Gg, Gs^Fds, Gg, Gg, Gg, Gg, Re, Re, Gg^Eff, Re^Eff, Gs^Vl, Rb^Gvs, Rb^Gvs, Re, Re, Gs^Fds, Gg, Gs^Fds, Gg^Eff, Gs^Fds, Gs^Qhhf, Hh^Qhhf, Gs^Fds, Gs^Qhhf
Gs^Fds, Gs^Fds, Gs^Fds, Gs^Fds, Gs^Fds, Gs^Fds, Gs^Qhhf, Gs^Qhhf, Gs^Fds, Gs^Fds, Gs^Fds, Gs^Fds, Gg, Gg, Gg, Gg, Gg, Gg, Gg, Re, Re^Ecf, Re, Re, Re, Gg, Gs^Fds, Gs^Fds, Gs^Fds, Gs^Qhhf, Gs^Qhhf, Gs^Fms, Gs^Qhhf, Gs^Fds, Gs^Qhhf, Gs^Fds
Gs^Fds, Gs^Fds, Gs^Fds, Gs^Fds, Gs^Fds, Gs^Fds, Gs^Qhhf, Gs^Qhhf, Gs^Fms, Gs^Fds, Gs^Fds, Gg^Fds, Gg, Gg, Gg, Gg, Ce, Ce, Ce, Re^Edt, Rb, Re^Edt, Ce, Ce, Ce, Gg, Gg, Gs^Qhhf, Gg, Gs^Qhhf, Gg, Gll^Fp, Gll^Fp, Gs^Fms, Gs^Fms
Gs^Fds, Gs^Fds, Gs^Fds, Gs^Fds, Gs^Em, Gs^Fms, Gll^Fp, Gs^Qhhf, Gll^Fp, Gg, Gg^Efm, Gg, Gg, Gg^Efm, Gg, Gg, Ce, 1 Ke, Ce, Re^Ecf, Rb^Edt, Rb^Ecf, Ce, 2 Ke, Ce, Gg, Gg, Gg, Gs^Fms, Gg, Gg, Gg^Efm, Gg^Efm, Gg, Gg
Gs^Fds, Gs^Fds, Gs^Fds, Gs^Fds, Gs^Fds, Gs^Fds, Gs^Fms, Gll^Fp, Gll^Fp, Gll^Fp, Gg^Efm, Gg^Efm, Gg, Gg, Gg, Gg, Rb, Ce, Re, Re^Edt, Re, Re, Re, Ce, Re, Gg, Gg, Gs^Fds, Gs^Fds, Gs^Fms, Gg, Gg^Efm, Gg, Gg, Gg^Efm
Gs^Fds, Gs^Fds, Gs^Fds, Gs^Fds, Gs^Fds, Gll^Fp, Gs^Fms, Gll^Fp, Gll^Fp, Gll^Fp, Gll^Fp, Gg, Gg, Gg, Gg, Gg, Gg, Re, Gg, Gs, Re^Edt, Gs, Gg, Re, Gg, Gg, Gg, Gs^Fds, Gg, Gg^Efm, Gg, Gg, Gg, Gg, Gg
Gs, Gs^Fds, Gs, Gs^Fds, Gs, Gs^Fds, Gs^Fds, Gs^Fms, Gs^Fds, Gll^Fp, Gs^Fds, Gs^Fds, Gg, Gg, Gg, Gg, Gg, Gg, Gg, Gg, Gg, Re^Edt, Gg, Gg, Gg, Gg, Gg, Gg, Gg, Gg, Gg, Gg, Gg, Gg, Gs
