Hhd^Qhhf, Hhd^Qhhf, Hhd^Qhhf, Hhd^Qhhf, Gll^Fp, Gll^Fp, Hhd^Qhhf, Gg, Gg, Gg, Gll^Fp, Gll^Fp, Re, Gg, Gll, Gll^Fp, Gll^Fp, Gg, Hhd^Qhhf, Hhd^Qhhf, Hhd^Qhh, Hhd^Qhh, Hhd^Qhh, Hhd^Qhhf, Hhd^Qhhf, Gs^Qhhf, Gs^Fp, Gs^Qhhf, Gll^Qhhf, Gs^Qhhf, Gll^Fp, Gll^Fp, Gll^Fp, Gs^Qhhf, Gll^Fp, Gs^Qhhf, Gll^Fp, Gs^Qhhf, Gll^Qhhf, Gll^Qhhf, Gll^Fp, Gll^Fp, Gll^Qhhf, Re, Gll^Fp, Gs^Qhhf, Hhd^Qhhf, Hhd^Qhh, Hhd^Qhh, Hhd^Qhhf, Gll^Qhhf, Ww, Wo, Wo, Wo, Gs
Hhd^Qhhf, Hhd^Qhhf, Hhd^Qhhf, Hhd^Qhhf, Hhd^Qhhf, Hhd^Qhhf, Gs^Fp, Gs^Fp, Gg, Gg, Gll^Fp, Gll^Fp, Re, Gg, Gll^Em, Gll^Em, Gll^Em, Gll^Fp, Hhd^Qhhf, Hhd^Qhh, Hhd^Qhhf, Hhd^Qhh, Hhd^Qhhf, Hhd^Qhhf, Gll^Fp, Gs^Fp, Gll^Qhhf, Gll^Fp, Gll^Qhhf, Gll^Qhhf, Hhd^Qhhf, Gll^Fp, Hhd^Qhhf, Hhd^Qhhf, Hhd^Qhhf, Hhd^Qhhf, Hhd^Qhhf, Hhd^Qhhf, Hhd^Qhhf, Gll^Qhhf, Gll^Fp, Gll^Qhhf, Re, Re, Gll^Fp, Gll^Qhhf, Hhd^Qhhf, Hhd^Qhh, Hhd^Qhh, Hhd^Qhhf, Ww^Es, Ww, Wo, Wo, Wo, Gll^Qhhf
Hhd^Qhhf, Hhd^Qhhf, Gll^Fp, Hhd^Qhhf, Hhd^Qhhf, Gs^Fp, Gg, Gg, Re^Eff, Re^Eff, Re, Re, Gll^Fp, Gll, Gll, Gll^Fp, Gll^Fp, Hhd^Qhhf, Hhd^Qhh, Hhd^Qhh, Gll^Eff, Hhd^Qhhf, Gll^Es, Gll^Fp, Gll^Es, Gll^Qhhf, Gll^Fp, Gll^Fp, Hhd^Qhhf, Hhd^Qhhf, Hhd^Qhhf, Hhd^Qhhf, Mm^Qhh, Mm^Qhh, Mm^Qhh, Hhd^Qhh, Hhd^Qhhf, Hhd^Qhhf, Hhd^Qhhf, Gll^Qhhf, Gll^Fp, Gll^Fp, Re, Gll^Fp, Gll^Qhhf, Hhd^Qhhf, Hhd^Qhhf, Hhd^Qhhf, Gll^Qhhf, Gll^Qhhf, Wo, Wo, Wo, Wo, Ww, Gll^Qhhf
Hhd^Qhhf, Hhd^Qhhf, Gll^Fp, Gll^Fp, Gg, Gs^Fp, Re^Edb, Re^Edb, Rb^Gvs, Rb^Gvs, Rb^Gvs, Re, Gs, Gs, Gs, Gll^Fp, Rb^Gvs, Rb^Gvs, Rb^Gvs, Rb^Gvs, Rb^Gvs, Gll^Eff, Gll^Eff, Gll, Gll^Fp, Gll^Es, Gll^Fp, Gll^Fp, Gll^Fp, Hhd^Qhhf, Gll^Fp, Hhd^Qhh, Hhd^Qhhf, Hhd^Qhhf, Hhd^Qhhf, Hhd^Qhhf, Gll^Fp, Hhd^Qhhf, Gll^Fp, Hhd^Qhhf, Gll^Es, Re^Fp, Re, Gll^Fp, Gll^Qhhf, Hhd^Qhhf, Ss, Ss, Ww^Es, Wo, Wo, Wo, Wo, Wo, Gll^Qhhf, Gll^Qhhf
Gs^Fp, Gs^Fp, Gll^Em, Gll^Em, Gg^Eff, Gg^Eff, Rb^Gvs, Ur, Rb^Gvs, Rb^Gvs, Rb^Gvs, Re^Edb, Re, Re, Re, Rb^Gvs, Re^Ecf, Rb^Gvs, Rb^Gvs, Rb^Gvs, Rb^Gvs, Rb^Gvs, Re^Wm, Gll^Eff, Rb^Gvs, Gll^Eff, Gll^Eff, Gll^Fp, Gll^Fp, Gll^Fp, Gll^Fp, Gll^Fp, Gll^Fp, Gll^Fp, Gll^Fp, Gll^Fp, Gll^Fp, Gll^Fp, Gll^Fp, Gll^Es, Gll, Re, Ce, Ce, Gll^Fp, Gll^Qhhf, Ss, Ww^Es, Wo, Wo, Wo, Wo, Gll^Qhhf, Gll^Qhhf, Hhd^Qhhf, Hhd^Qhhf
Gs^Fp, Gs^Fp, Gll^Eff, Gll, Re, Rb^Gvs, Rb^Gvs, Rb^Gvs, Rb^Gvs, Rb^Gvs, Re^Edb, Re, Cer, Cer, Cer, Re, Re, Rb^Gvs, Re^Edb, Rb^Vl, Re, Rb^Gvs, Rb^Gvs, Rb^Gvs, Rb^Gvs, Rb^Gvs, Rb^Gvs, Gll, Gll, Gll^Fp, Gll^Es, Gll^Fp, Gll^Fp, Gll^Fp, Gll^Fp, Gll^Fp, Gll^Fp, Gll^Fp, Gll^Es, Gll, Re, Re, Ce, Ke, Gll^Qhhf, Gll^Qhhf, Wo, Wo, Wo, Wo, Ww, Gll^Qhhf, Hhd^Qhhf, Gll^Qhhf, Hhd^Qhhf, Hhd^Qhh
Gs^Fms, Gll^Eff, Rb^Gvs, Rb^Gvs, Ur, Re^Edb, Re^Edb, Rb^Gvs, Ur, Rb^Edb, Rb, Re^Edb, Cer, 2 Ke, Cer, Rb^Vct, Re, Re^Edb, Re, Re, Re^Ecf, Re, Re, Re, Re, Rb^Gvs, Re, Re, Re, Gll, Re, Gll, Re, Gll, Gll, Gll, Re, Gll, Re, Re, Gll^Fp, Gll^Fp, Gll^Fp, Gll^Fp, Wo, Wo, Wo, Wo, Wo, Ww, Gll^Qhhf, Hhd^Qhhf, Hhd^Qhhf, Hhd^Qhhf, Hhd^Qhhf, Hhd^Qhhf
Gs^Fms, Rb^Gvs, Rb^Gvs, Rb^Gvs, Rb^Gvs, Rb^Gvs, Re, Re, Rb^Gvs, Rb^Gvs, Re^Ecf, Rb, Rb^Vct, Cer, Rb^Vct, Rb, Rb, Cer, Re, Rb^Gvs, Rb^Gvs, Rb^Gvs, Rb^Gvs, Rb^Gvs, Rb^Vl, Re, Gs^Eff, Re^Gvs, Re^Gvs, Re, Gs, Re, Gs, Re, Re, Re, Gg, Re, Rb^Gvs, Rb^Gvs, Rb^Gvs, Gll^Fp, Gg, Ww^Es, Wo, Wo, Wo, Wo, Hhd^Qhhf, Ss, Ss, Hhd^Qhh, Hhd^Qhhf, Gll^Fp, Gll^Fp, Gs^Fp
Gs^Fms, Rb^Gvs, Rb^Gvs, Rb^Gvs, Re^Eff, Re^Eff, Rb^Gvs, Rb^Gvs, Rb^Gvs, Rb^Gvs, Re^Edb, Re^Edb, Rb, Rb, Re, Re, Re, Re, Rb^Gvs, Rb^Gvs, Rb^Gvs, Rb^Gvs, Gs^Eff, Gs^Eff, Gg^Eff, Gs^Eff, Gg, Gg, Gg, Gs^Vl, Gg, Re, Gg, Gg, Gg, Gs^Vl, Gg, Gs^Fms, Rb^Gvs, Rb^Gvs, Rb^Gvs, Gg, Ww, Wo, Wo, Wo, Ww, Gll^Em, Gll^Fp, Ss, Hhd^Qhhf, Ss, Gll^Fp, Gll^Fp, Gll^Fp, Gll^Fp
Gg, Gg^Eff, Gg^Eff, Re^Eff, Re, Re, Rb^Gvs, Rb^Gvs, Ur, Rb^Gvs, Re, Re, Cer, Rb, Re, Cer, Re, Rb^Vl, Re^Eff, Re^Eff, Gg^Eff, Gs^Eff, Gg, Gg, Ww, Gg, Wo, Ww, Wo, Ww, Wo, Wog^Bw|, Wo, Wo, Wo, Gg, Wo, Gg, Gg, Gs^Vl, Gg, Gg, Wo, Wo, Wo, Ww, Gll, Gll, Hhd^Qhhf, Hhd^Qhhf, Hhd^Qhh, Hhd^Qhhf, Hhd^Qhhf, Gll^Qhhf, Hhd^Qhhf, Gll^Fp
Re, Re, Re, Re, Gs, Re, Gs^Eff, Re^Edb, Re^Edb, Rb^Gvs, Re, Re, Re^Edb, Re^Edb, Rb^Gvs, Re, Rb^Gvs, Rb^Gvs, Gs, Gg, Ww, Gg, Wo, Wo, Wo, Wo, Wo, Wo, Wo, Wo, Ket, Wog^Bw|, Ket, Wo, Wo, Wo, Wo, Wo, Wo, Gg, Ww, Ww, Wo, Wo, Wo, Ww, Gll, Gll^Fp, Gll^Em, Gll^Fp, Gll, Hhd^Qhhf, Gll^Em, Hhd^Qhhf, Gll^Qhhf, Gll^Fp
Gg, Gs, Gg, Gs, Gg^Eff, Gs^Eff, Rb^Gvs, Rb^Gvs, Rb^Gvs, Re^Eff, Re^Eff, Re, Re^Edb, Ur, Rb^Gvs, Rb^Gvs, Rb^Gvs, Gs, Gg, Ww, Wo, Wo, Wo, Wo, Ce, Wo, Ce, Ket, Ce, Ket, Ket, Chr, Ket, Ket, Ce, Ce, Ket, Wo, Wo, Wo, Wo, Wo, Wo, Wo, Wo, Gll, Gll, Gll^Em, Gll^Vl, Gll, Gll, Gll, Gll, Gll^Fp, Gll^Fp, Re^Qhhf
Gg, Gg, Gg, Gg, Gg^Eff, Rb^Gvs, Rb^Gvs, Rb^Gvs, Rb^Gvs, Rb^Gvs, Rb^Gvs, Re, Re, Rb^Gvs, Rb^Gvs, Rb^Gvs, Gg^Eff, Gg, Wo, Wo, Wo, Wo, Ce, Ket, Rb^Edt, Ket, Re, Gs^Fds, Gs, Gs^Fms, Rp, Ket, Rp, Gs, Gs^Fds, Re^Vl, Rb, Ce, Ket, Wo, Wo, Wo, Wo, Wo, Ww, Gll, Gll, Re, Re, Re, Ce, Ke, Ce, Gll, Hhd^Fp, Hhd^Qhhf
Gg, Gg, Gg, Gg, Gg, Gg^Eff, Gg^Eff, Gg^Eff, Gg^Eff, Rb^Gvs, Rb^Gvs, Rb^Gvs, Gs^Vl, Re, Gg, Gg^Eff, Gg, Ww, Wo, Wo, Ce, Ket, Gs^Fds, Rb^Edt, Re^Vl, Re, Rp, Re^Vl, Rp, Rp, Hh^Fp, Rp, Re^Es, Rp, Rp, Re^Vl, Rp, Re^Vc, Re^Edt, Ce, Ket, Wog^Bw/, Wo, Wo, Wo, Ww, Gll, Gll^Fp, Gll^Fp, Re, Re, Ce, Re, Hhd^Fp, Hhd^Fp, Hhd^Fp
Ww^Es, Ww^Es, Ww^Es, Gg, Ww, Gg, Ww, Ww, Ww, Gg^Eff, Gg^Eff, Gg^Eff, Gg, Re, Gg, Gg, Ww, Wo, Wo, Wo, Ce, Gs^Fds, Re^Eff, Re^Eff, Rp, Rp, Re^Es, Rp, Hh^Fp, Hh^Qhh, Ket, Hh^Qhh, Hh^Fp, Re^Es, Re, Rp, Re^Vl, Rp, Rp, Re^Vc, Ket, Wog^Bw/, Wog^Bw/, Wo, Wo, Ww, Gll, Gll^Fp, Gll, Gll, Gll, Re, Re, Gll, Gll^Fp, Hhd^Fp
Hh^Qhh, Hh^Qhh, Hh^Qhh, Ww^Es, Hh, Ww, Gs^Fds, Gg, Gg, Ww, Ww, Ww, Ww, Ww^Bw|, Ww, Ww, Wo, Wo, Ce, Ket, Gs, Gs^Fds, Re^Vl, Rp, Gs, Gs, Hh^Fp, Hh^Qhh, Ce, Ce, Rp, Ce, Ce, Hh^Qhh, Hh^Fp, Re, Rp, Rp, Re, Rp, Rb^Edt, Ket, Wo, Wo, Ww, Ww, Ww, Gll, Ww, Ww, Ww, Gll, Gll, Re, Gll^Fp, Gll^Fp
Hh^Qhhf, Hh^Qhh, Hh^Qhh, Hh^Qhh, Hh^Fms, Gs^Fds, Hh^Qhhf, Gs^Fds, Hh^Qhh, Hh^Qhh, Gg^Es, Gg, Gg, Re, Gg, Ww, Wo, Wo, Ket, Gs^Fds, Gs, Re, Re, Rp, Gs^Fds, Gs, Hh^Qhh, Ket, Rp, Rp, Ket^Qhh, Rp, Rp, Ket, Ce^Ebn, Rp, Gs, Gs^Fds, Re^Vl, Rp, Re^Vl, Ce, Wo, Wo, Wo, Ww, Gg, Ww, Gg, Gg, Gg, Ww, Re, Re, Gll, Gll^Fp
Hh, Hh^Qhhf, Hh^Qhh, Hh^Qhh, Hh^Qhh, Hh, Hh^Qhh, Hh^Qhh, Hh^Qhhf, Hh^Qhh, Hh, Gg, Re, Re, Gg^Eff, Ww, Wo, Wo, Ce, Gs, Re^Vl, Re, Rp, Rp, Re, Rb^Es, Hh^Fp, Ce, Rp, Ket^Qhh, 3 Ket^Vl, Ket^Qhh, Rp, Ce, Rp, Rp, Gs^Fds, Gs, Re, Rp, Rb, Ket, Wo, Wo, Wo, Ww, Ww, Gg, Rb^Gvs, Gg, Re, Ww^Bw/, Ww, Gll, Gg, Gll
Gs^Fds, Hh^Fms, Gs^Qhhf, Hh^Qhhf, Gs^Fds, Hh, Hh, Hh^Qhh, Hh, Gs^Fds, Gs^Fds, Gs^Fds, Re, Gs^Vl, Gg^Eff, Gg^Eff, Wo, Wo, Ket, Gs^Fds, Re, Rp, Re, Re^Vl, Rb, Rb^Es, Hh^Qhh, Ce, Rp, Ket^Qhh, Ket^Qhh, Ket^Qhh, Rp, Ce, Ce^Ebn, Rp, Rp, Re, Re^Vl, Rp, Re^Vl, Ce, Wo, Wo, Wo, Ww, Ww, Rb^Gvs, Rb^Gvs, Rb^Gvs, Re, Gg, Gg, Ww, Gs^Fms, Gg
Gs^Fds, Gs^Fds, Gs^Fds, Gs^Qhhf, Gs^Qhhf, Gs^Fds, Gs^Fds, Rb^Gvs, Rb^Gvs, Hh, Gs^Fds, Gs^Fds, Re, Gg, Gg, Gg, Ww, Wo, Ket, Ket, Ket, Rp, Rp, Gs^Fds, Gs, Gs, Hh^Fp, Ket, Ce, Rp, Rp, Rp, Ce, Ket, Hh^Fp, Re, Re, Rp, Rp, Rp, Ket, Ket, Wo, Wo, Wo, Ww, Rb^Gvs, Rb^Gvs, Rb^Gvs, Rb^Gvs, Re, Gg, Gs^Fms, Ww, Ww, Gs^Fms
Gs^Qhhf, Gs^Fds, Gs^Qhhf, Hh^Qhhf, Hh, Hh^Fms, Gg^Eff, Rb^Gvs, Rb^Gvs, Rb^Gvs, Rb^Gvs, Re^Edt, Re^Edt, Gg, Gg, Gg, Gg, Wo, Wo^Bw/, Chr, Ket, Re^Vl, Rp, Re, Gs^Fds, Gs, Re, Hh^Qhh, Hh^Fp, Ce, Ket, Ce, Hh^Fp, Hh^Qhh, Re^Es, Re, Re, Rp, Rp^Eff, Ket, Chr, Ket, Wo, Wo, Ww, Ww, Gs^Vl, Rb^Gvs, Re, Re, Rb^Gvs, Rb^Gvs, Rb^Gvs, Gs^Fms, Gs^Fms, Ww
Ww^Es, Gs^Qhhf, Ww^Es, Hh^Qhh, Hh^Qhh, Hh, Hh, Gg^Eff, Gg^Eff, Rb^Gvs, Re, Ur, Re^Edt, Re, Re, Gs^Vl, Re, Wo^Bw/, Wo, Ket, Ket, Re, Rp, Re^Vl, Re, Gs, Gs, Re, Re^Es, Hh^Qhh, Hh^Fp, Hh^Qhh, Re, Re^Es, Re, Gs^Fms, Re^Vl, Rp^Eff, Gs^Fms, Ket, Ket, Wo^Bw\, Wo^Bw\, Wo, Gg, Gg, Gg, Re, Re, Rb^Gvs, Rb^Gvs, Rb^Gvs, Rb^Gvs, Gs^Fms, Gs^Fms, Gs^Fms
Hh^Qhhf, Ww^Es, Gs^Fds, Ww^Es, Ww^Es, Gg^Es, Gg, Gg, Gg, Gg, Gs, Re, Re, Rb^Gvs, Rb^Gvs, Re^Edt, Re^Edt, Ww, Wo, Wo, Ce, Re^Vc, Rb^Edt, Rp, Rp, Gs^Fds, Re^Vc, Re, Rp, Rp, Rp, Rp, Rp, Rp, Rp, Rp, Gs^Fds, Gs^Fms, Ce, Ket, Wo, Wo, Wo, Wo^Bw\, Re, Gg, Gs^Eff, Gs^Fds, Re, Gs^Vl, Gs^Fms, Rb^Gvs, Re^Eff, Re^Eff, Gg, Gs^Fms
Hh^Qhhf, Hh^Qhhf, Hh^Qhhf, Gs^Fds, Ww, Gg, Ww, Gg, Ww, Gg, Gg, Gs, Re, Rb^Gvs, Rb^Gvs, Ur, Re, Gg, Wo, Wo, Wo, Ce, Ket, Re^Vl, Ce, Rp, Rp, Rp, Gs^Fds, Re, Gs^Fds, Re, Gs^Fms, Re^Vl, Re, Re^Vl, Ket, Ce, Wo, Wo, Wo, Wo, Wo, Gg, Gs^Vl, Re, Re, Gs^Eff, Re, Gs, Gs^Fms, Gs^Fms, Rb^Gvs, Rb^Gvs, Gg, Gs^Fms
Hh^Qhhf, Hh^Qhhf, Hh^Qhhf, Hh^Fms, Hh^Fms, Ww, Gs^Fds, Ww, Gg^Efm, Ww, Ww^Bw/, Re, Gg, Rb^Gvs, Gs^Fds, Gs, Re, Gg, Gg, Wo, Wo, Wo, Wo, Ce, Wo, Ket, Ket, Ket, Ce, Ce, Ket, Ce, Ce, Ket, Ce, Ce, Wo, Wo, Wo, Wo, Wo, Wo, Gg, Gg, Gs^Eff, Re^Eff, Re, Re, Gs, Re, Re, Rb^Gvs, Rb^Gvs, Rb^Gvs, Rb^Gvs, Gg
Hh^Fms, Hh^Fms, Hh^Qhhf, Hh^Qhhf, Hh^Fms, Hh^Fms, Gs^Fds, Gs^Fds, Re, Re, Ww, Ww, Gg, Gs^Fds, Gs^Fds, Gs^Fds, Gs^Fds, Re, Re, Ww, Ww, Wo, Wo, Wo, Wo, Wog^Bw|, Wog^Bw|, Wog^Bw|, Wo, Wo, Wo, Wo, Wo, Wo, Wo, Wo, Wo, Wo, Ww, Ww, Ww, Ww, Gg, Gs, Re, Re, Rb^Gvs, Rb^Gvs, Rb^Gvs, Gs, Gs^Fms, Gs^Vl, Rb^Gvs, Rb^Gvs, Rb^Gvs, Gg
Gs^Fds, Gs^Fds, Gs^Fds, Hh^Fms, Gs^Fds, Re^Vl, Re, Gg^Efm, Re, Gs, Rb^Gvs, Ww, Ww, Gg, Gg, Gg, Gg, Gg, Gg, Re, Ww, Wo, Ww, Wo, Wo, Wo, Wo, Wo, Wo, Wo, Wo, Wo, Wo, Wo, Ww, Wo, Ww, Ww, Gg, Ww, Ww, Gg, Gg, Gg, Re, Rb^Gvs, Rb^Gvs, Rb^Gvs, Gs, Gs^Fms, Gs^Fms, Gg, Gs, Gs^Fds, Hh^Fms, Gs^Fds
Gs^Fds, Gs^Fds, Gg, Gs^Fds, Rb^Gvs, Rb^Gvs, Re^Vl, Re, Rb^Gvs, Re^Vl, Rb^Gvs, Gs, Ww, Gg, Ww, Ww, Ww, Ww, Ww, Re, Ww, Ww, Ww, Ww, Gg, Ww, Gg, Ww, Gg, Ww, Gg, Ww, Gg, Ww, Gg, Gg, Gg, Gg, Gg, Ww, Gg, Gg, Gg^Fds, Re, Rb^Gvs, Gs^Vl, Rb^Gvs, Rb^Gvs, Gs, Gs^Fds, Rb^Gvs, Rb^Gvs, Rb^Gvs, Gs^Fds, Hh^Fms, Hh^Fms
Gg, Gg, Gg, Gg, Gg, Rb^Gvs, Gg^Efm, Re, Gg^Efm, Rb^Gvs, Gs, Gs, Ww, Ww, Ww, Ww, Ww, Ww, Gg, Ww^Bw|, Gg, Ww, Gg, Gg, Re, Gg, Gg, Gg, Gg, Gg, Gg, Gg, Gg, Gg, Gg, Gg, Gs, Gs, Gg, Wwf^Es, Gg, Gg, Gs^Fds, Re, Re, Rb^Gvs, Re, Re^Eff, Re^Eff, Rb^Gvs, Rb^Gvs, Rb^Gvs, Rb^Gvs, Rb^Gvs, Gg, Hh^Fms
Ww, Ww, Ww, Ww, Ww, Ww, Ww, Ww^Bw|, Ww, Ww, Ww, Ww, Ww, Ww, Gg, Ww, Gg, Ww, Gg, Re, Re, Re, Re, Re, Gs, Re, Re, Re, Re, Re, Re, Gs^Eff, Gs^Eff, Gg, Cer, Re, Gs, Gs, Gg, Ww, Gg, Gs^Fds, Gs^Fds, Gs^Fds, Re, Re, Rb^Gvs, Re, Re, Gs^Vl, Gs, Rb^Edt, Rb^Edt, Rb^Gvs, Gg, Hh^Fms
Ww, Ww, Ww, Ww, Ww, Ww, Ww, Ww^Bw|, Ww, Ww, Ww, Ww, Gg, Gg, Gg, Gg, Wwf, Ww, Gg, Gg, Gg, Gg, Gg, Gg, Gs, Gs, Gs, Gs, Rb^Gvs, Rb^Gvs, Re^Vl, Re, Re, Re, Re, Re, Re, Cer, Gg, Wwf^Es, Ww, Gg, Gg, Gg, Re, Gs, Rb^Gvs, Rb^Gvs, Rb^Gvs, Re, Re, Gs, Hh^Fds, Gs, Hh^Fds, Gg
Gs^Fms, Gs^Fms, Gs^Fms, Gg, Gg, Gg, Gg, Re, Gg, Gg, Gg, Gg, Gg, Gg, Gg, Gg, Ww, Gg, Gs^Fds, Gg, Gg^Efm, Gg^Efm, Gg, Gs^Fds, Gs^Fms, Gs^Fds, Gs^Fds, Gs, Rb^Gvs, Rb^Gvs, Rb^Gvs, Rb^Gvs, Cer, Re, Rb^Gvs, Rb^Gvs, Cer, Re, Re, Gg, Wwf^Es, Gg, Gg, Re, Gs, Gs^Fds, Gs^Fds, Rb^Edt, Rb^Edt, Rb^Edt, Gs^Fds, Re, Gs^Fds, Hh^Fds, Hh^Fds, Hh^Fds
Gs^Fms, Gs^Fms, Gs^Fms, Gs^Fms, Gg, Gg, Gg, Re, Gs^Vl, Gg, Gg, Gg^Efm, Gg^Efm, Gs^Fds, Gs^Fds, Gs^Fds, Gs^Fds, Ww, Ww, Gs^Fds, Gs^Fms, Gs^Fds, Gs^Fds, Gs^Fms, Gs^Fms, Gs^Fms, Gs, Re^Eff, Re^Eff, Rb^Gvs, Rb^Gvs, Rb^Gvs, Re, Rb^Gvs, Rb^Gvs, Cer, 1 Ke, Cer, Re, Re^Ecf, Gg, Ww, Gg, Re, Gs^Fds, Gs^Fds, Gs^Fds, Re^Edt, Re^Edt, Re^Eff, Re^Eff, Re, Ur, Rb^Gvs, Gg^Fds, Hh^Fds
Gs^Fds, Gs^Fds, Gs^Fds, Gs^Fds, Gs^Fms, Gs^Fds, Gs^Fds, Re, Re, Gg, Gg, Gg^Efm, Gg, Gs^Fds, Gg, Gs^Fds, Gs^Fds, Gs^Fds, Ww^Es, Gs^Fds, Gs^Fds, Gs^Fds, Gs^Fms, Gs^Fms, Gg, Gs^Fds, Rb^Gvs, Rb^Gvs, Re^Vl, Re, Re^Ecf, Re, Re, Re, Re, Cer, Cer, Cer, Re, Re, Ur, Ww^Edt, Re, Re, Re^Eff, Re^Eff, Re^Edt, Re^Edt, Rb^Gvs, Re, Re, Rb^Edt, Rb^Gvs, Rb^Gvs, Rb^Gvs, Gs
Gll^Fp, Gll^Fp, Gll^Fp, Gs^Fds, Gs^Fds, Gs^Fds, Gg, Gg, Gg, Gg, Gll^Fp, Gg, Ww, Ww, Ww, Gg, Wwf, Ww^Es, Gg, Gs^Fds, Gg, Gs^Fms, Gg, Gg, Gg, Rb^Gvs, Rb^Gvs, Rb^Gvs, Rb^Gvs, Re, Rb^Gvs, Rb^Gvs, Re^Vl, Re, Re, Re, Re, Re, Gg, Re, Wwg^Bw\, Ww^Edt, Re, Re, Re, Re, Re, Rb^Gvs, Rb^Edt, Rb^Gvs, Rb^Gvs, Re, Rb^Wm, Rb^Gvs, Hh^Fds, Gs
Gll^Fp, Gs^Fms, Gs^Fms, Gg, Gg^Efm, Gg, Gg, Gll^Fp, Gll^Fp, Gll^Fp, Gll^Fp, Gll^Fp, Ww^Es, Gll^Fp, Gll^Fp, Ww, Gll^Fp, Gg, Gg, Gg, Gg^Efm, Gg, Gg, Gg, Gg^Eff, Rb^Gvs, Rb^Gvs, Rb^Gvs, Re^Eff, Re^Eff, Rb^Gvs, Rb^Gvs, Rb^Edt, Rb^Edt, Gs, Gs, Gg, Re^Ecf, Gg, Ww, Ww, Re, Rb^Gvs, Rb^Gvs, Rb^Gvs, Rb^Gvs, Re, Rb^Edt, Rb^Edt, Ur, Rb^Edt, Rb^Gvs, Re, Re, Hh^Fds, Hh^Fds
Gs^Fds, Gs^Fms, Gg, Gg^Efm, Gg^Efm, Gg, Gll^Fp, Gll^Fp, Mm, Mm, Mm, Mm, Ww^Es, Gll^Fp, Mm, Gll^Fp, Gll^Fp, Gll^Fp, Gg, Gg^Efm, Gg^Efm, Gg, Gg, Gg, Gg, Gg^Eff, Gg^Eff, Re^Eff, Gg, Re^Eff, Re^Eff, Rb^Gvs, Gg, Rb^Edt, Gs^Fds, Gs^Fds, Gg, Gg, Ww, Ww, Gg, Gg, Rb^Gvs, Ur, Rb^Edt, Rb^Gvs, Re, Re, Re, Re, Re, Rb^Gvs, Re, Hh^Fds, Hh^Fds, Hh^Fds
Gs^Fms, Gs^Fds, Gg, Gg, Gs^Fds, Gg, Gll^Fp, Gll^Fp, Gll^Fp, Gll^Fp, Gll^Fp, Mm, Mm, Mm, Gll^Fp, Mm, Gll^Fp, Gll^Fp, Gll^Fp, Gg, Gg, Gg, Gs^Fds, Gs^Fds, Gs^Fds, Gg, Gg, Gs^Fds, Gs^Fds, Gg, Gs^Fds, Gg, Gg, Gg, Gg, Gs^Fds, Gg, Ww, Ww, Gg, Gs^Fds, Gs^Fds, Rb^Gvs, Rb^Edt, Rb^Edt, Rb^Edt, Re, Re, Rb^Gvs, Rb^Gvs, Rb^Edt, Re, Re, Gg^Fds, Hh^Fds, Hh^Fds
Gs^Fds, Gs^Fds, Gs^Fds, Gs^Fds, Gs^Fms, Gs^Fms, Gs^Fms, Gll^Fp, Gs^Fms, Gll^Fp, Gll^Fp, Mm, Gll^Fp, Gll^Fp, Gll^Fp, Gll^Fp, Gll^Fp, Gll^Fp, Gs^Fms, Gg, Gg, Gg, Gs^Fds, Gs^Fms, Gs^Fms, Gs^Fds, Gs^Fds, Gs^Fds, Gs^Fds, Gs^Fds, Gs^Fds, Gs^Fds, Gs^Fds, Gs^Fds, Gg, Gg, Ww, Ww, Gg, Gg, Gs^Fds, Gs^Fds, Gs^Fds, Gs^Fds, Gs^Fds, Gs, Re, Rb^Gvs, Ur, Rb^Edt, Rb^Edt, Rb^Edt, Re, Gs, Gg^Fds, Gg^Fds
Gs^Fms, Gs^Fms, Gs^Fms, Gs^Fms, Gll^Fp, Gs^Fms, Gll^Fp, Gs^Fms, Gs^Fms, Gll^Fp, Gll^Fp, Gll^Fp, Gll^Fp, Gll^Fp, Gll^Fp, Gll^Fp, Gll^Fp, Gll^Fp, Gs^Fms, Gll^Fp, Gll^Fp, Gs^Fms, Gs^Fms, Gs^Fms, Gs^Fds, Gs^Fms, Gs^Fms, Gs^Fds, Gs^Fds, Gs^Fds, Gs^Fds, Gs^Fds, Gs^Fds, Gs^Fds, Gg, Ww, Ww, Gg, Gs^Fds, Gs^Fds, Gs^Fds, Gs^Fds, Gs^Fds, Gs^Fds, Gs^Fds, Gs, Re, Rb^Gvs, Rb^Gvs, Rb^Gvs, Rb^Gvs, Rb^Gvs, Re, Gs, Gs, Gg^Fds
Gs^Fms, Gs^Fms, Gg, Gs^Fds, Gg^Fms, Gll^Fp, Gg, Gs^Fms, Gg, Gs^Fms, Gg, Gll^Fp, Gg, Gll^Fp, Gg^Fms, Gs^Fms, Gg, Gs^Fms, Gg, Gll^Fp, Gg, Gll^Fp, Gg, Gs^Fms, Gs^Fds, Gs^Fds, Gg, Gs^Fds, Gg, Gs^Fds, Gg, Gg^Fds, Wog, Gg, Gg, Ww, Gg, Gg, Gg, Gs^Fds, Gg, Gs^Fds, Gs, Gs^Fds, Gs, Gs, Re, Re, Re, Rb^Gvs, Re, Re, Re, Gs, Gs, Gs
