Hh^Fms, Hh^Fms, Hh^Fms, Hh^Fms, Hh^Fms, Hh^Fms, Hh^Fms, Gg, Gg^Efm, Gg, Gs^Fms, Gg, Rb^Gvs, Rb^Gvs, Rb^Gvs, Gg^Fms, Rb^Fms, Gg, Hh^Fms, Hh^Fms, Hh^Fms, Hh^Fms, Hh^Fms, Hh^Fms, Hh^Fms, Gs, Gs^Fms, Gs, Gll^Fms, Gs, Gll^Fp, Gll^Fp, Gll^Fp, Gs, Gll^Fp, Gs, Gll^Fp, Gs, Gll^Fp, Gll^Fp, Gll^Fp, Gll^Fp, Gll^Fp, Re, Gll^Fp, Gs, Hhd^Fp, Hhd^Fp, Hhd^Fp, Hhd^Fp, Gll^Fp, Gs, Wog, Wog, Wog, Gs
Hh^Fms, Hh^Fms, Hh^Fms, Hh^Fms, Hh^Fms, Hh^Fms, Gs^Fms, Gs^Fms, Gg^Efm, Gg^Efm, Gs, Gs^Dr, Rb^Gvs, Rb^Gvs, Rb^Gvs, Rb^Gvs, Rb^Gvs, Gs^Fms, Hh^Fms, Hh^Fms, Hh^Fms, Hh^Fms, Hh^Fms, Hh^Fms, Gs^Fms, Gs^Fms, Gll^Fms, Gll^Fms, Gll^Fp, Gll^Fp, Hhd^Fp, Gll^Fp, Hhd^Fp, Hhd^Fp, Hhd^Fp, Hhd^Fp, Hhd^Fp, Hhd^Fp, Hhd^Fp, Gll^Fp, Gll^Fp, Gll^Fp, Re, Re, Gll^Fp, Gll^Fp, Hhd^Fp, Hhd^Fp, Hhd^Fp, Hhd^Fp, Gll^Fp, Gll^Fp, Wog, Wog, Wog, Gll^Fp
Hh^Fms, Hh^Fms, Gs^Fms, Hh^Fms, Hh^Fms, Gs^Fms, Gg^Efm, Rb^Gvs, Rb^Gvs, Rb^Gvs, Rb^Gvs, Gs, Gs^Fms, Rb^Gvs, Rb^Gvs, Gs^Fms, Gs^Fms, Hh^Fms, Hh^Fms, Hh^Fms, Gs^Fms, Hh^Fms, Gs^Efm, Gs^Fms, Gs, Gll^Fms, Gll^Fms, Gll^Fms, Hhd^Fp, Hhd^Fp, Hhd^Fp, Hhd^Fp, Mm^Fp, Mm^Fp, Mm^Fp, Hhd^Fp, Hhd^Fp, Hhd^Fp, Hhd^Fp, Gll^Fp, Gll^Fp, Gll^Fp, Re, Gll^Fp, Gll^Fp, Hhd^Fp, Hhd^Fp, Hhd^Fp, Gll^Fp, Gll^Fp, Wog, Wog, Wog, Wog, Gll^Fp, Gll^Fp
Hh^Fms, Hh^Fms, Gg^Efm, Gg^Efm, Gg, Gs^Fms, Gg, Rb^Gvs, Rb^Edt, Rb^Gvs, Rb^Edt, Rb^Gvs, Gs, Gg, Gg^Efm, Gs^Fms, Gg^Efm, Gg^Efm, Rb^Gvs, Rb^Gvs, Rb^Gvs, Gs, Gs^Efm, Gs^Efm, Gs^Fms, Gll, Gll^Fms, Gll^Fms, Gll^Fp, Hhd^Fp, Gll^Fp, Hhd^Fp, Hhd^Fp, Hhd^Fp, Hhd^Fp, Hhd^Fp, Gll^Fp, Hhd^Fp, Gll^Fp, Hhd^Fp, Re, Re^Fp, Gll^Em, Gll^Fp, Gll^Fp, Hhd^Fp, Gll^Fp, Gll^Fp, Gll^Fp, Wog, Wog, Wog, Wog, Wo, Gll^Fp, Gll^Fp
Gs^Fms, Gs^Fms, Rb^Gvs, Rb^Gvs, Rb^Gvs, Rb^Edt, Re, Gs^Dr, Re, Rb^Edt, Rb^Edt, Gs, Re, Re, Re, Gg, Gs, Rb^Gvs, Rb^Gvs, Rb^Gvs, Rb^Gvs, Gs, Gs^Wm, Gs, Gs, Gs, Gs, Gll^Fms, Gll^Fms, Gll^Fms, Gll^Fms, Gll^Fms, Gll^Fms, Gll^Fp, Gll^Fms, Gll^Fp, Gll^Fms, Gll^Fms, Gll^Fms, Gll^Em, Re, Gll^Em, Ce, Ce, Gll^Fp, Gll^Fp, Gll^Fp, Gll^Fp, Wog, Wog, Wog, Wog, Gll^Fp, Gll^Fp, Hhd^Fp, Hhd^Fp
Gs^Fms, Gs^Fms, Rb^Gvs, Rb^Gvs, Rb^Edt, Rb^Edt, Rb^Edt, Re, Gs^Edt, Gs^Edt, Re^Edb, Re, Cer, Cer, Cer, Re, Gs, Rb^Gvs, Rb^Gvs, Gs^Vl, Rb^Gvs, Rb^Gvs, Re, Re, Re, Re, Re, Gs, Gs, Gll^Fms, Gll^Efm, Gll^Fms, Gll^Fms, Gll^Fms, Gll^Fms, Gll^Fms, Gll^Fms, Gll^Fms, Re, Re, Gll^Em, Re, Ce, Ke, Gll^Fp, Gll^Fp, Wog, Wog, Wog, Wog, Gll^Fp, Gll^Fp, Hhd^Fp, Gll^Fp, Hhd^Fp, Hhd^Fp
Hh^Fms, Gg^Efm, Gg^Efm, Gs^Dr, Re, Rb^Edt, Re^Ecf, Re, Gs^Edt, Re^Edb, Re, Re, Cer, 2 Ke, Cer, Re^Vct, Gs, Gs^Gvs, Gs^Gvs, Rb^Gvs, Re, Re, Rb^Gvs, Rb^Gvs, Rb^Gvs, Rb^Gvs, Rb^Gvs, Re, Re, Gs^Efm, Gs^Efm, Gll, Gs, Gll^Efm, Gs, Gs, Gs^Efm, Gs, Re, Gll, Gll^Fp, Gll^Fp, Gll^Fp, Gll^Fp, Wog, Wog, Wog, Wog, Wog, Gll, Gll^Fp, Hhd^Fp, Hhd^Fp, Hhd^Fp, Hhd^Fp, Hhd^Fp
Hh^Fms, Hh^Fms, Gs^Fms, Gg, Gs, Re, Rb^Edt, Re, Gs^Edt, Gs^Edt, Re, Re, Re^Vct, Cer, Re^Vct, Re, Rb^Gvs, Cer, Rb^Gvs, Gs, Re, Rb^Gvs, Rb^Gvs, Rb^Gvs, Gs^Vl, Rb^Gvs, Rb^Gvs, Rb^Gvs, Gs^Gvs, Re, Re, Gs^Efm, Re, Re, Re, Re, Re, Re, Re, Gs, Gs, Gll^Fp, Gs, Wog, Wog, Wog, Wog, Wog, Hhd^Fp, Gll, Gll, Hhd^Fp, Hhd^Fp, Gll^Em, Gll^Fp, Gs^Fp
Hh^Fms, Hh^Fms, Hh^Fms, Gg, Rb^Gvs, Rb^Edt, Rb^Edt, Re, Re, Re, Rb^Edt, Re, Gs, Re, Re, Rb^Edt, Rb^Gvs, Rb^Gvs, Rb^Gvs, Rb^Gvs, Re, Gs, Gs^Fms, Gs^Fms, Gs^Efm, Gs, Gs^Efm, Gs^Fms, Gs^Efm, Gs^Vl, Gs^Gvs, Re, Gs, Gs, Gs^Gvs, Gs^Vl, Gs^Gvs, Gs^Fms, Gs^Gvs, Re, Re, Gs, Wog, Wog, Wog, Wog, Gs, Gll^Em, Gll^Fp, Gll^Em, Hhd^Fp, Gll^Em, Gll, Gll, Gll^Em, Gll
Hh^Fms, Hh^Fms, Hh^Fms, Gg^Efm, Gg^Efm, Rb^Gvs, Gs^Dr, Rb^Edt, Re, Re, Rb^Edt, Rb^Ecf, Cer, Gs, Re, Cer, Rb^Gvs, Gs^Vl, Re, Re, Gs^Efm, Gs, Gs^Efm, Gs, Gs^Efm, Gs^Efm, Wog, Gs^Efm, Wog, Gs, Wog, Wog^Bw|, Wog, Wog, Wog, Gs, Wog, Gs, Gs^Gvs, Gs^Vl, Gs^Gvs, Gs, Wog, Wog, Wog, Gs, Gs, Gll, Hhd^Fp, Hhd^Fp, Hhd^Fp, Hhd^Fp, Hhd^Fp, Gll^Fp, Hhd^Fp, Gs
Hh^Fms, Hh^Fms, Hh^Fms, Gs^Fms, Gg^Efm, Rb^Gvs, Gg^Efm, Gs, Gg, Gs, Rb^Gvs, Rb^Edt, Rb^Gvs, Rb^Gvs, Gs, Re, Re, Re, Gs^Efm, Gs, Gs, Gs, Wog, Wog, Wog, Wog, Wog, Wog, Wog, Wog, Ket, Wog^Bw|, Ket, Wog, Wog, Wog, Wog, Wog, Wog, Gs, Gs, Gs, Wog, Wog, Wog, Gs, Gs, Gll^Fp, Gs^Gvs, Gll^Fp, Gll, Hhd^Fp, Gll^Em, Hhd^Fp, Gll^Fp, Gll^Fp
Hh^Fms, Hh^Fms, Hh^Fms, Hh^Fms, Hh^Fms, Gs^Fms, Hh^Fms, Hh^Fms, Gs^Fms, Gg, Gg^Efm, Rb^Gvs, Gs^Dr, Rb^Gvs, Re, Re, Gg^Efm, Gg, Gs, Gs, Wog, Wog, Wog, Wog, Ce, Wog, Ce, Ket, Ce, Ket, Ket, Ce^Bw|, Ket, Ket, Ce, Ce, Ket, Wog, Wog, Wog, Wog, Wo, Wog, Wog, Wog, Gs, Gs, Gs^Gvs, Gs^Vl, Gs^Gvs, Re, Re, Re, Gll^Fp, Gll^Fp, Re^Fp
Hh^Fms, Hh^Fms, Gs^Fms, Hh^Fms, Hh^Fms, Hh^Fms, Hh^Fms, Gs^Fms, Gs^Fms, Gs^Fms, Gg, Gs, Gs, Gs, Re, Gg, Gg^Efm, Gs, Wog, Wog, Wog, Wog, Ce, Ket, Gll, Ket, Gll, Gll^Fms, Gll, Gll^Fms, Re, Ket, Re, Gll, Gll^Fds, Re^Vl, Gll, Ce, Ket, Wog, Wog, Wog, Wog, Wog, Wog, Gs, Gll, Re, Re, Re, Ce, Ke, Ce, Re, Hhd^Fp, Hhd^Fp
Gs^Fms, Gs^Fms, Gg^Efm, Hh^Fms, Hh^Fms, Hh^Fms, Gg^Efm, Gs^Fms, Gg, Gg, Rb^Gvs, Rb^Gvs, Gs^Vl, Re, Gg, Gg^Efm, Gg, Gs, Wog, Wog, Ce, Ket, Gll^Fms, Gll, Re^Vl, Gll, Re, Re^Vl, Re, Re, Hh^Fms, Re, Gll, Re, Re, Re^Vl, Re, Re^Vl, Gll, Ce, Ket, Wog^Bw/, Wog, Wog, Wog, Gs, Gll, Gll^Fp, Gs^Fp, Gll, Gs, Ce, Gs, Hhd^Fp, Hhd^Fp, Hhd^Fp
Wwf, Wwf, Wwf, Gg^Efm, Wwf, Gg^Efm, Wwf, Wwf, Wwf, Gg, Gg, Rb^Gvs, Gs, Re, Gg, Gg^Efm, Gs, Wog, Wog, Wog, Ce, Gll^Fds, Gll, Gll, Re, Re, Gll, Re, Hh^Fms, Hh^Fms, Ket, Hh^Fms, Hh^Fms, Gll, Gll, Re, Re^Vl, Re, Re, Re^Vc, Ket, Wog^Bw/, Wog^Bw/, Wog, Wog, Gs, Gs, Gs^Fp, Gs, Gs, Gs, Re, Re, Gll, Gll^Fp, Hhd^Fp
Gs^Fms, Gs^Fms, Gs^Fms, Wwf, Gg^Efm, Wwf, Gg, Gs, Gg, Wwf, Wwf, Wwf, Wwf, Wwf^Bw|, Wwf, Wwf, Wog, Wog, Ce, Ket, Gll, Gll^Fds, Re^Vl, Re, Gll, Gll, Hh^Fms, Hh^Fms, Ce, Ce, Re, Ce, Ce, Hh^Fms, Hh^Fms, Gll, Gll, Gll, Gll, Re, Gll, Ket, Wog, Wog, Wog, Wwf, Wwf, Gs, Wwf, Wwf, Wwf, Gs, Gs, Re, Gs^Fp, Gll^Fp
Gs^Fms, Gs^Fms, Hh^Fds, Hh^Fds, Hh^Fds, Gg^Efm, Hh^Fds, Gg, Hh^Fds, Gg^Efm, Gg, Gs, Gs, Re, Gs, Gs, Wog, Wog, Ket, Gll^Fds, Gll, Gll, Gll, Re, Gll^Fds, Gll, Hh^Fms, Ket, Re, Re, Ket, Re, Re, Ket, Hh^Ebn, Gll, Gll, Gll^Fms, Re^Vl, Re, Re^Vl, Ce, Wog, Wog, Wog, Wwf, Gs, Wwf, Gs, Gs, Gs, Wwf, Re, Re, Gs, Gs^Fp
Gs^Fds, Hh^Fms, Mm^Fms, Mm^Fds, Mm^Fds, Hh^Fds, Gs^Fms, Hh^Fds, Hh^Fds, Hh^Fds, Gs^Fms, Gg, Re, Re, Gs^Eff, Gs, Wog, Wog, Ce, Gll, Re^Vl, Gll, Re, Re, Gll, Gll, Hh^Fms, Ce, Re, Ket, 3 Ket^Vl, Ket, Re, Ce, Re, Gll, Gll^Fds, Gll, Gll, Re, Gll, Ket, Wog, Wog, Wog, Gs, Gs, Gs, Rb^Gvs, Gs, Re, Wwf, Wwf, Gs, Gg, Gs
Gs^Fds, Hh^Fms, Hh^Fms, Mm^Fms, Hh^Fds, Hh^Fds, Gg^Efm, Gg, Gs, Gg^Efm, Gg^Efm, Gg, Re, Gs^Vl, Gs^Eff, Gs^Eff, Wog, Wog, Ket, Gll^Fms, Gll, Re, Gll, Re^Vl, Gll, Gll, Hh^Fms, Ce, Re, Ket, Ket, Ket, Re, Ce, Hh^Ebn, Re, Re, Gll, Re^Vl, Re, Re^Vl, Ce, Wog, Wog, Wog, Gs, Rb^Gvs, Rb^Gvs, Rb^Gvs, Rb^Gvs, Re, Gs^Efm, Gg^Efm, Wwf, Hh^Fms, Gg
Gs^Fms, Hh^Fds, Hh^Fds, Hh^Fds, Hh^Fds, Gs^Fms, Gg^Efm, Rb^Gvs, Rb^Gvs, Gs^Efm, Gs, Gs, Re, Gs, Gs, Gs, Wog, Wog, Ket, Ket, Ket, Re, Re, Gll^Fds, Gll, Gll, Hh^Fms, Ket, Ce, Re, Re, Re, Ce, Ket, Hh^Fms, Gll, Gll, Re, Re, Re, Ket, Ket, Wog, Wog, Wog, Gs, Rb^Gvs, Rb^Gvs, Rb^Gvs, Rb^Gvs, Re, Gg^Efm, Gg^Fds, Wwf, Wwf, Hh^Fms
Gg, Hh^Fds, Gg^Efm, Hh^Fds, Hh^Fds, Hh^Fds, Gg^Efm, Rb^Gvs, Rb^Gvs, Rb^Gvs, Rb^Gvs, Gs, Re, Gs, Gs, Gs, Gs, Wog, Wog^Bw/, Ce^Bw/, Ket, Re^Vl, Re, Gll, Gll^Fds, Gll, Gll, Hh^Fms, Hh^Fms, Ce, Ket, Ce, Hh^Fms, Hh^Fms, Gll, Gll, Gll, Re, Re, Ket, Ce^Bw\, Ket, Wog, Wog, Wog, Gs, Gs^Vl, Rb^Gvs, Re, Re, Rb^Gvs, Rb^Gvs, Rb^Gvs, Hh^Fms, Hh^Fms, Hh^Fms
Wwf, Gg, Wwf, Gg^Efm, Gg, Hh^Fds, Gs^Fms, Gg, Gs^Efm, Rb^Gvs, Gs, Gs^Dr, Re, Re, Re, Gs^Vl, Re, Wog^Bw/, Wog, Ket, Ket, Gll, Re, Re^Vl, Gll, Gll, Gll, Gll, Gll, Hh^Fms, Hh^Fms, Hh^Fms, Gll, Gll, Gll, Gll^Fds, Re^Vl, Re, Gll^Fms, Ket, Ket, Wog^Bw\, Wog^Bw\, Wog, Gs, Gs, Gs^Efm, Re, Re, Rb^Gvs, Rb^Gvs, Rb^Gvs, Rb^Gvs, Hh^Fms, Hh^Fms, Hh^Fms
Hh^Fms, Wwf, Gs^Fds, Wwf, Wwf, Gg, Gg, Gg^Efm, Gs^Efm, Gs^Efm, Gs^Efm, Gs, Re, Rb^Gvs, Rb^Gvs, Re, Re, Gs, Wog, Wog, Ce, Re^Vl, Gll, Re, Re, Gll^Fds, Re^Vc, Gll, Re, Re, Re, Re, Re, Re, Re, Re, Gll^Fms, Gll^Fms, Ce, Ket, Wog, Wog, Wog, Wog^Bw\, Re, Gs, Gs, Gs^Fds, Re, Gs^Vl, Gs^Fds, Rb^Gvs, Gg, Gg^Efm, Gg^Efm, Hh^Fms
Hh^Fms, Hh^Fms, Hh^Fds, Gs^Fds, Wwf, Gs, Wwf, Gs, Wwf, Gs^Efm, Gs, Gs, Re, Rb^Gvs, Rb^Gvs, Gs^Dr, Re, Gs, Wog, Wog, Wog, Ce, Ket, Re^Vl, Ce, Re, Re, Re, Gll^Fds, Gll, Gll^Fms, Gll, Gll^Fds, Re^Vl, Gll, Re^Vl, Ket, Ce, Wog, Wog, Wog, Wog, Wog, Gg, Gs^Vl, Re, Re, Gs, Re, Gs^Efm, Gs^Fds, Gs^Fds, Rb^Gvs, Rb^Gvs, Gg^Efm, Gg^Fds
Hh^Fms, Hh^Fms, Hh^Fms, Hh^Fms, Hh^Fms, Wwf, Gs^Fds, Wwf, Gg^Gvs, Wwf, Wwf^Bw/, Re, Gg^Efm, Rb^Gvs, Gs^Fds, Gg, Re, Gs, Gs, Wog, Wog, Wog, Wog, Ce, Wog, Ket, Ket, Ket, Ce, Ce, Ket, Ce, Ce, Ket, Ce, Ce, Wog, Wog, Wog, Wog, Wog, Wog, Gs, Gs, Gs^Efm, Gs, Re, Re, Gs, Re, Re, Rb^Gvs, Rb^Gvs, Rb^Gvs, Rb^Gvs, Gg
Hh^Fms, Hh^Fms, Hh^Fms, Hh^Fms, Hh^Fms, Hh^Fms, Gs^Fds, Gs^Fds, Re, Re, Wwf, Wwf, Gg^Efm, Gs^Fds, Gs^Fds, Gs^Fds, Gs^Fds, Re, Re, Gs, Gs, Wog, Wog, Wog, Wog, Wog^Bw|, Wog^Bw|, Wog^Bw|, Wog, Wog, Wog, Wog, Wog, Wog, Wog, Wog, Wog, Wog, Wwg, Wwg, Wwg, Wwg, Gs, Gs^Efm, Re, Re, Rb^Gvs, Rb^Gvs, Rb^Gvs, Gg, Hh^Fms, Gs^Vl, Rb^Gvs, Rb^Gvs, Rb^Gvs, Gs
Gs^Fds, Gs^Fds, Gs^Fds, Hh^Fms, Gs^Fds, Gs^Vl, Gg, Gs, Re, Gs, Gg^Gvs, Wwf, Wwf, Gg^Efm, Gg, Gg^Efm, Gg, Gg^Efm, Gs, Re, Wwg, Ww, Wwg, Wog, Wog, Wog, Wog, Wog, Wog, Wog, Wog, Wog, Wog, Wog, Wwg, Wog, Wwg, Wwg, Gs, Wwg, Wwg, Gs, Gg^Efm, Gs^Efm, Re, Rb^Gvs, Rb^Gvs, Rb^Gvs, Gg, Hh^Fms, Hh^Fms, Gg, Gs, Gs^Fds, Hh^Fms, Gs^Fds
Gs^Fds, Gs^Fds, Gg^Efm, Gs^Fds, Gg^Gvs, Gg^Gvs, Gs^Vl, Re, Gg^Gvs, Gs^Vl, Gg^Gvs, Gs, Wwf, Gs, Wwg, Wwg, Wwg, Wwg, Wwg, Wwg^Bw|, Wwg, Wwg, Wwg, Wwg, Gs, Wwg, Gs, Wwg, Gs, Wwg, Gs, Wwg, Gs, Wwg, Gs, Gs, Gs, Gs, Gs, Wwg, Gs, Gs, Gg^Fds, Re, Rb^Gvs, Gs^Vl, Rb^Gvs, Rb^Gvs, Gg, Hh^Fms, Rb^Gvs, Rb^Gvs, Rb^Gvs, Hh^Fms, Hh^Fms, Hh^Fms
Gg, Gg^Efm, Gg, Gg^Efm, Gg, Gg^Gvs, Gs, Re, Gs, Gg^Gvs, Gs, Gs, Wwg, Wwg, Wwg, Wwg, Wwg, Wwg, Gs, Wwg^Bw|, Re, Wwg, Gs, Gs, Re, Gs, Gg^Efm, Gs, Gg, Gs, Gs, Gs, Gg^Efm, Gs, Gg^Efm, Gg, Gg^Efm, Gg^Efm, Gs, Wwg, Gs, Gg^Efm, Hh^Fds, Re, Re, Rb^Gvs, Re, Gs, Gs, Rb^Gvs, Rb^Gvs, Rb^Gvs, Rb^Gvs, Rb^Gvs, Gg^Efm, Hh^Fms
Wwg, Wwg, Wwg, Wwg, Wwg, Wwg, Wwg, Wwg^Bw|, Wwg, Wwg, Wwg, Wwg, Wwg, Wwg, Gs, Wwg, Gs, Wwf, Gs, Re, Gs, Re, Re, Re, Gs, Re, Re, Re, Re, Re, Re, Gg^Efm, Gs, Gg^Efm, Cer, Gg, Gg, Gg^Efm, Gs, Wwg, Gg, Gg^Fds, Hh^Fds, Hh^Fds, Re, Re, Rb^Gvs, Re, Re, Gs^Vl, Gg, Rb^Edt, Rb^Edt, Rb^Gvs, Gg^Efm, Hh^Fms
Wwg, Wwg, Wwg, Wwg, Wwg, Wwg, Wwg, Wwg^Bw|, Wwg, Wwg, Wwg, Wwg, Gs, Gs, Gg, Gs, Wwf, Wwf, Gg^Efm, Gs^Efm, Gg^Efm, Gs, Gg, Gg, Gg^Efm, Gs, Gg^Efm, Gs, Rb^Gvs, Rb^Gvs, Gs^Vl, Re, Re, Gd, Re, Re, Re, Cer, Gs, Wwf, Wwf, Gg^Efm, Gg^Efm, Gg^Efm, Re, Gg, Rb^Gvs, Rb^Gvs, Rb^Gvs, Re, Re, Gg^Efm, Hh^Fds, Gg, Hh^Fds, Gg
Gs, Gs, Gs, Gs, Gs, Gs, Gs, Gs, Gs, Gs, Gs, Gs, Gg, Gg, Gg^Efm, Gg, Wwf, Gg^Efm, Gs^Fds, Gg^Efm, Gg, Gg^Efm, Gg, Hh^Fds, Hh^Fds, Hh^Fds, Hh^Fds, Gg, Rb^Gvs, Rb^Gvs, Rb^Gvs, Rb^Gvs, Cer, Re, Rb^Gvs, Rb^Gvs, Cer, Re, Re, Gs, Wwf, Gs, Gs, Re, Gg^Efm, Hh^Fds, Hh^Fds, Rb^Edt, Rb^Edt, Rb^Edt, Gs^Fds, Re, Gg^Fds, Hh^Fds, Hh^Fds, Hh^Fds
Gg, Gg, Gg, Gg, Gg, Gg, Gg, Gs, Gs^Vl, Gs^Efm, Gs^Efm, Gs^Efm, Gg, Gs^Fds, Hh^Fms, Hh^Fms, Hh^Fms, Wwf, Hh^Fms, Hh^Fms, Hh^Fds, Hh^Fms, Gg^Efm, Hh^Fds, Gg^Efm, Gs^Fds, Gg, Gg, Gs, Rb^Gvs, Rb^Gvs, Rb^Gvs, Re, Rb^Gvs, Rb^Gvs, Cer, 1 Ke, Cer, Re^Ecf, Gs, Gs, Wwg, Gs, Re, Gs^Fds, Hh^Fds, Gg^Fds, Re^Edt, Re^Edt, Gs, Re, Re, Rb^Dr, Rb^Gvs, Gg^Fds, Hh^Fds
Hh^Fms, Gs^Fds, Hh^Fms, Gs^Fds, Hh^Fms, Hh^Fms, Gs^Fds, Gg^Efm, Gs, Gs, Gg, Gs^Efm, Gg, Hh^Fms, Gs^Efm, Hh^Fms, Hh^Fds, Hh^Fms, Hh^Fms, Hh^Fms, Hh^Fms, Hh^Fms, Hh^Fms, Gg^Efm, Gg, Gg^Efm, Rb^Gvs, Rb^Gvs, Gs^Vl, Re, Re, Re, Re, Gg, Gg, Cer, Cer, Cer, Re, Re, Gs, Wwg, Gs, Re, Re, Re, Re^Edt, Re^Edt, Rb^Gvs, Re, Re, Rb^Edt, Rb^Gvs, Rb^Gvs, Rb^Gvs, Gs
Hh^Fms, Hh^Fms, Hh^Fms, Hh^Fds, Gs^Fds, Hh^Fms, Gg, Gg, Gg, Gg, Gs^Fds, Gg, Gg^Efm, Gg^Efm, Gg^Efm, Gg^Efm, Gg^Efm, Hh^Fms, Gg, Gs^Fds, Gg, Hh^Fms, Gg, Gg, Gs, Rb^Gvs, Rb^Gvs, Rb^Gvs, Rb^Gvs, Gs, Rb^Gvs, Rb^Gvs, Gs^Vl, Re, Gs, Gg, Gs, Re^Ecf, Gg, Re, Wwg^Bw\, Wwg, Re, Re, Re, Re, Re, Rb^Gvs, Rb^Edt, Rb^Gvs, Rb^Gvs, Re, Gs^Wm, Rb^Gvs, Hh^Fds, Gs
Hh^Fms, Hh^Fms, Hh^Fms, Gg, Gg^Efm, Gg^Efm, Gg, Gs^Fds, Hh^Fds, Hh^Fms, Hh^Fds, Gs^Fms, Hh^Fms, Gs^Fms, Hh^Fds, Gg^Efm, Gs^Fds, Gg^Efm, Gg, Gg, Gs^Efm, Gg, Gs^Efm, Gs^Efm, Gs, Rb^Gvs, Rb^Gvs, Rb^Gvs, Gs, Gs, Rb^Gvs, Rb^Gvs, Rb^Edt, Rb^Edt, Gs, Gg^Efm, Gg^Efm, Gg^Efm, Gs, Wwg, Wwg, Re, Rb^Gvs, Rb^Gvs, Rb^Gvs, Rb^Gvs, Re, Rb^Edt, Rb^Edt, Rb^Dr, Rb^Edt, Rb^Gvs, Gg, Gg^Efm, Hh^Fds, Hh^Fds
Gs^Fds, Hh^Fms, Gg, Gg^Efm, Gg^Efm, Gg^Efm, Hh^Fms, Hh^Fds, Mm^Fds, Mm^Fds, Mm^Fds, Hh^Fms, Hh^Fds, Hh^Fds, Mm^Fms, Hh^Fms, Hh^Fms, Gs^Fds, Gg, Gs^Efm, Gs^Efm, Gg^Efm, Gg^Efm, Gg^Efm, Gg, Gs, Gg, Gg, Gg^Efm, Gg, Gg^Efm, Rb^Gvs, Gg, Rb^Edt, Gs^Fds, Gs^Fds, Gg^Efm, Gg, Wwg, Wwg, Gs, Gs, Rb^Gvs, Rb^Dr, Rb^Edt, Rb^Gvs, Re, Re, Re, Re, Re, Rb^Gvs, Gg, Hh^Fds, Hh^Fds, Hh^Fds
Gs^Fds, Gs^Fds, Gg, Gg^Efm, Gs^Fds, Gg, Gs^Fms, Hh^Fms, Hh^Fds, Mm^Fds, Hh^Fms, Hh^Fms, Hh^Fms, Mm^Fms, Mm^Fms, Mm^Fp, Hh^Fms, Hh^Fms, Gs^Fms, Gg, Gs^Efm, Gg^Efm, Gs^Fds, Hh^Fms, Hh^Fms, Gg, Gg, Hh^Fms, Gs^Fds, Gg^Efm, Hh^Fms, Gg^Efm, Gg, Gg^Efm, Gg^Efm, Gs^Fds, Gs, Gs, Wwg, Gs, Gs^Fds, Gs^Fds, Rb^Gvs, Rb^Edt, Rb^Edt, Rb^Edt, Re, Re, Rb^Gvs, Rb^Gvs, Rb^Edt, Re, Re, Gg^Fds, Hh^Fds, Hh^Fds
Gs^Fds, Gs^Fds, Gs^Fds, Gs^Fds, Gs^Fds, Gs^Fms, Gs^Fms, Gs^Fds, Gs^Fds, Hh^Fds, Gs^Fds, Gs^Fds, Gs^Fms, Hh^Fms, Hh^Fms, Hh^Fms, Gs^Fms, Gs^Fms, Gs^Fms, Gg, Gg, Gg, Hh^Fms, Hh^Fms, Hh^Fms, Hh^Fms, Hh^Fms, Hh^Fms, Hh^Fms, Hh^Fms, Hh^Fms, Gs^Fds, Gs^Fds, Gs^Fds, Gg, Gg, Wwg, Wwg, Gs, Gs, Gs^Fds, Gs^Fds, Gs^Fds, Gs^Fds, Gs^Fds, Gs, Re, Rb^Gvs, Rb^Dr, Rb^Edt, Rb^Edt, Rb^Edt, Re, Gg^Efm, Gg^Fds, Gg^Fds
Gs^Fds, Gs^Fds, Gs^Fms, Gs^Fms, Gs^Fms, Gs^Fms, Gs^Fms, Gs^Fms, Gs^Fms, Gs^Fms, Gs^Fms, Gs^Fms, Gs^Fms, Gs^Fms, Gs^Fms, Gs^Fms, Gs^Fms, Gs^Fms, Gs^Fms, Gs^Fms, Gs^Fms, Gs^Fds, Gs, Hh^Fms, Gs^Fds, Hh^Fms, Hh^Fms, Hh^Fms, Hh^Fms, Hh^Fms, Gs^Fds, Hh^Fms, Gs^Fds, Gg^Efm, Gg, Wwg, Gs, Gs, Gs^Fds, Gs^Fds, Gs^Fds, Gs^Fds, Gs^Fds, Gs^Fds, Gs^Fds, Gs, Re, Rb^Gvs, Rb^Gvs, Rb^Gvs, Rb^Gvs, Rb^Gvs, Re, Gs^Efm, Gs^Efm, Gg^Fds
Gs^Fms, Gs^Fds, Gg, Gs^Fms, Gg^Fms, Gs^Fms, Gg, Gs^Fms, Gg, Gs^Fms, Gg, Gs^Fms, Gg, Gs^Fms, Gg^Fms, Gs^Fms, Gg, Gs, Gg, Gs^Fms, Gg, Gs, Gg, Gs, Gs, Gs, Gg, Gs, Gg, Gs, Gg, Gg^Fds, Wog, Gg, Gg, Wwg, Gg, Gs, Gg, Gs^Fds, Gg, Gs^Fds, Gs, Gs^Fds, Gg, Gg, Re, Re, Gg, Rb^Gvs, Gg, Gs, Gg, Gs, Gs, Gg
