Gs, Gs^Fms, Gll^Fp, Gll^Fp, Ww, Gll^Fp, Gll^Fp, Gs, Gll^Fp, Gll^Fp, Gll^Fp, Gs^Fms, Gs^Fms, Re, Gg, Gs^Fds, Gs^Fds, Gs^Fds, Gs^Fds, Gs, Gs^Fds, Gs^Fds, Ww, Gg, Re, Gs^Fds, Gs^Fds, Gs^Fds, Gs^Qhhf, Gs, Gg, Gs, Gs^Fds, Gs^Fms, Gs^Fds, Gs^Fds, Gs^Fds, Gs, Gs, Re, Gg, Gs, Gs^Qhhf, Gg, Gs^Fds, Gs^Fds, Gs^Fds, Gs^Fds, Gs^Fds, Gs^Fds, Gs^Fds, Gs^Fds, Gs^Fds
Gll^Fp, Gll^Fp, Gll^Fp, Gll^Fp, Gll^Fp, Ww, Gll^Fp, Gll^Fp, Gll^Fp, Gll^Fp, Gs^Fms, Gs^Fms, Re, Re, Gg, Gs^Fds, Gs^Fds, Gs^Fds, Gs^Fds, Gs^Fds, Gs^Fds, Gs^Fds, Gg, Ww^Es, Re, Gg, Gs^Fds, Gs^Fds, Gs^Fds, Gs^Qhhf, Gg^Efm, Gg^Efm, Gg, Gs^Fds, Gg, Gs^Fds, Gg, Gg, Gg, Re, Gg, Gs, Gs^Qhhf, Gs^Fds, Gs^Qhhf, Gs^Fds, Gs^Fds, Gs^Fds, Gs^Fds, Gs^Fds, Gs^Fds, Gs^Fds, Gs^Fds
Gll^Fp, Gll^Fp, Gll^Fp, Gll^Fp, Gll^Fp, Ww, Ww, Gll^Em, Gll^Em, Gll^Fp, Gll^Fp, Gs^Fms, Re, Gg, Gs^Fds, Gs^Fds, Gs^Fds, Gs^Fds, Gs^Fds, Gs^Fds, Gs^Fds, Rb^Gvs, Re, Wwf^Es, Ww^Es, Gg, Gs^Fds, Gs^Qhhf, Gs^Qhhf, Gs^Qhhf, Gg, Gg^Efm, Gg, Gg, Gg, Gg, Gs^Fds, Gs^Fds, Gs^Fms, Re, Re, Gs^Fds, Gs^Qhhf, Gs^Fds, Gs^Qhhf, Gs^Qhhf, Gs^Fds, Gs^Fds, Gg, Gs^Fds, Gs^Fds, Gs^Fds, Gs^Fds
Gll^Fp, Gll^Fp, Gll^Fp, Gll^Fp, Gll^Fp, Gll^Fp, Ww, Gll^Em, Gll^Em, Gll^Fp, Gll^Fp, Gs^Fms, Re, Gs^Fds, Gs^Qhhf, Gs^Qhhf, Gs^Qhhf, Gs^Fds, Gs^Fds, Gs^Fds, Rb^Gvs, Gg^Vl, Re, Gg, Ww, Gg, Gg, Gg, Gg, Gg, Gg^Qhhf, Gs^Fds, Gs^Qhhf, Gs^Qhhf, Gs^Qhhf, Gs^Qhhf, Gs^Qhhf, Gs^Fds, Gs^Fds, Gg, Re, Gs^Qhhf, Gg, Gs^Qhhf, Gg, Gg, Gg^Efm, Gg, Gs^Fds, Gs^Fds, Gs^Fds, Gs^Fds, Gs^Fds
Gll^Fp, Gll^Fp, Gll^Fp, Gll^Fp, Gll^Fp, Gll^Fp, Gll^Fp, Ww, Gll^Em, Gll, Gll, Re, Gg, Gs^Fds, Gs^Qhhf, Ww, Gs^Qhhf, Gs^Fds, Gs^Fds, Gs^Fds, Rb^Gvs, Rb^Gvs, Gg^Eff, Wwf, Re, Ww, Ww, Ww, Ww, Ww, Ww, Gg^Qhhf, Gs^Fds, Gs^Fds, Gs^Fds, Gs^Fds, Gs^Qhhf, Gg^Fds, Re^Eff, Gg, 4 Gg, Re, Gg, Gg^Efm, Gg, Gg^Efm, Gg^Efm, Gg, Gg, Gs^Fds, Gs^Fds, Gs^Fds, Gs^Fds
Gs^Fms, Gll^Fp, Gll^Fp, Gll^Fp, Gll^Fp, Gll^Fp, Gll^Fp, Ww, Re, Gll^Vl, Re, Re, Gs^Fds, Gs^Fds, Gs^Qhhf, Ww, Ww, Gs^Qhhf, Gg^Qhhf, Gg^Eff, Gg^Eff, Gg^Eff, Ww, Ww, Re, Gg, Gg^Eff, Gg^Eff, Gg^Eff, Gg^Fds, Ww, Gs^Qhhf, Gs^Qhhf, Gs^Fds, Gs^Fds, Gs^Fds, Gg^Fds, Gg^Qhhf, Rb^Gvs, Re^Eff, Re, Re, Gg, Gg, Gs^Fds, Gg, Gs^Fds, Gg, Gs^Fds, Gs^Fds, Gs^Fds, Gs^Fds, Gs^Fds
Gs^Fms, Gll^Fp, Gll^Fp, Gll^Fp, Gll^Em, Gll^Em, Re, Ww^Bw/, Ww, Re, Gg, Gg, Gs^Fds, Gs^Qhhf, Gs^Fds, Gs^Qhhf, Gs^Fds, Ww, Ww, Ww, Ww, Ww, Ww, Gg, Re, Rb^Gvs, Rb^Gvs, Rb^Gvs, Gg^Fds, Gs^Fds, Gs^Fds, Ww, Gs^Qhhf, Gs^Fds, Gs^Fds, Gs^Fds, Gg^Fds, Rb^Gvs, Rb^Gvs, Rb^Gvs, Re, Gg, Gs^Fds, Gs^Fds, Gs^Fds, Gs^Fds, Gs^Qhhf, Gs^Fds, Gs^Fds, Gs^Fds, Gs^Fds, Gs^Fds, Gs^Fds
Gll^Fp, Gll^Fp, Gll^Fp, Gll^Fp, Gll^Fp, Gll^Em, Gll^Vl, Gs^Fms, Gs^Fms, Ww, Gg, Gg^Efm, Gg^Efm, Gs^Fds, Gs^Fds, Gs^Fds, Gs^Fds, Gs^Fds, Gs^Fds, Gg, Gg, Gg, Ww^Es, Gg, Re, Rb^Gvs, Rb^Gvs, Rb^Gvs, Gs^Fds, Gs^Fds, Gs^Fds, Gs^Fds, Gs^Fds, Gs^Fds, Gs^Fds, Gg^Fds, Gg^Fds, Rb^Gvs, Rb^Gvs, Rb^Gvs, Re, Gs^Fds, Gs^Fds, Gs^Fds, Gs^Fds, Gs^Qhhf, Gs^Fds, Gs^Qhhf, Gs^Fds, Gs^Fds, Gs^Fds, Gs^Fds, Gs^Fds
Gll^Fp, Gll^Fp, Gll^Fp, Gll^Fp, Gll^Fp, Gll^Fp, Re, Gs^Fms, Gs^Fms, Ww, Gg, Gg^Efm, Gg, Gs^Fds, Rb^Gvs, Gs^Fds, Gs^Fds, Gs^Fds, Gs^Qhhf, Gg^Efm, Gg^Vl, Re, Re, Wwf^Es, Gg, Re, Rb^Gvs, Gg^Fds, Gs^Fds, Gs^Fds, Gs^Fds, Gs^Fds, Gs^Fds, Gs^Fds, Gg^Eff, Gg^Fds, Rb^Gvs, Rb^Gvs, Re^Eff, Re^Eff, Gs^Vl, Gg, Gs^Fds, Gs^Fds, Gg^Fds, Gs^Qhhf, Gs^Qhhf, Gs^Fds, Gs^Qhhf, Gs^Fds, Gs^Fds, Gs^Fds, Gs^Qhhf
Ww, Gll^Fp, Ww, Ww, Ww, Ww, Wwg^Bw|, Ww, Ww, Ww, Gg, Gg, Gg, Rb^Gvs, Rb^Gvs, Gs^Fds, Rb^Gvs, Gs^Qhhf, Gs^Qhhf, Gs^Fds, Rb^Gvs, Rb^Gvs, Gg, Ww^Es, Ww, Re^Eff, Re^Eff, Gg^Vl, Gs^Fds, Gs^Fds, Gs^Fds, Gs^Fds, Gg^Qhhf, Gg^Qhhf, Re, Re^Eff, Re, Re, Gg, Gg, Gg, Gg^Efm, Gg^Fds, Gg^Fds, Gg^Qhhf, Gg^Qhhf, Gg^Efm, Gs^Qhhf, Gg, Gs^Qhhf, Gs^Qhhf, Gs^Qhhf, Rb^Gvs
Gll^Fp, Ww, Gll^Fp, Gll^Fp, Gll^Fp, Gll^Fp, Re, Gg, Gg, Ww, Ww, Gg, Gg, Rb^Gvs, Gs^Vl, Rb^Gvs, Rb^Gvs, Gs^Fds, Gs^Qhhf, Gs^Qhhf, Gs^Fds, Rb^Gvs, Rb^Gvs, Gg, Ww, Gg, Re, Re, Gs^Qhhf, Gs^Qhhf, Gs^Qhhf, Gs^Fds, Gg^Qhhf, Re, Gg, Gg, Ww, Ww^Bw|, Ww, Gg, Gg, Gg, Gg, Gg, Gg, Gg, Gg, Gg, Gg^Vl, Rb^Gvs, Rb^Gvs, Rb^Gvs, Rb^Gvs
Gll^Fp, Gll^Fp, Gll^Fp, Gll^Fp, Gll^Fp, Gll^Em, Gll^Em, Re^Vl, Re, Gg, Gg, Ww, Gg, Gg, Gg^Eff, Rb^Gvs, Rb^Gvs, Rb^Gvs, Gs^Fds, Gs^Qhhf, Gs^Qhhf, Rb^Gvs, Gg^Efm, Gg, Ww, Gg, Re, Gg^Qhhf, Gs^Fds, Gs^Fds, Gs^Fds, Gg^Qhhf, Rb^Gvs, Re, Gg^Eff, Gg, Ww, Re, Gg, Ww, Ww, Ww, Ww, Ww, Ww, Gg, Gg^Eff, Gg^Eff, Rb^Gvs, Rb^Gvs, Rb^Gvs, Rb^Gvs, Rb^Gvs
Gll^Fp, Gll^Fp, Gll^Fp, Gll^Fp, Gll^Fp, Gll^Fp, Gll^Fp, Gs^Fms, Gs^Fms, Re, Gg, Ww, Ww, Gg, Gg^Efm, Gg^Eff, Gg, Gg^Fds, Gs^Fds, Ww, Gs^Qhhf, Gs^Fds, Gs^Fds, Gg, Ww, Gg, Re, Gg, Gg^Fms, Gs^Fds, Gg^Fds, Rb^Gvs, Rb^Gvs, Rb^Gvs, Gg^Eff, Gg^Eff, Ww, Re, Gg^Vl, Gg, Gg, Gg, Gg, Gg, Gg, Ww, Ww, Gg^Eff, Gg^Eff, Rb^Gvs, Rb^Gvs, Rb^Gvs, Gs^Fds
Gll^Fp, Gll^Fp, Gll^Fp, Gll^Fp, Gll^Fp, Gs^Fms, Gs^Fms, Gs^Fms, Gs^Fms, Re, Re, Gg, Ww, Gg, Gg, Gg, Ww, Ww, Ww, Ww, Gs^Fds, Gs^Fds, Gg^Fds, Gg, Re, Wwg^Bw/, Ww, Gg, Gg, Gg^Vl, Rb^Gvs, Rb^Gvs, Gg^Eff, Gg^Eff, Gg, Ww, Gg, Re, Gg, Gg^Efm, Gg, Gg, Gs^Qhhf, Gg, Gs^Fds, Gs^Fds, Ww, Gs^Fds, Gs^Fds, Gs^Fds, Gs^Fds, Gs^Fds, Gs^Fds
Gll^Fp, Gll^Fp, Gll^Fp, Gll^Fp, Gll^Fp, Gll^Fp, Gs^Fms, Gs^Fms, Gs^Fms, Gs^Fms, Re, Gg, Gg, Ww, Ww, Ww, Gg, Gg, Gg, Gs^Fds, Gs^Fds, Gs^Fds, Gs^Fds, Gg, Re, Gg, Gg, Ww, Gg, Gg^Eff, Gg^Eff, Gg^Eff, Ww, Gg, Ww, Ww, Re, Re, Gs^Fds, Gs^Qhhf, Gs^Qhhf, Gs^Qhhf, Gs^Fds, Gs^Qhhf, Gs^Qhhf, Gs^Fds, Gs^Fds, Gs^Fds, Gs^Fds, Gs^Fds, Gs^Fds, Gs^Qhhf, Gs^Qhhf
Gll^Fp, Gll^Fp, Gll^Fp, Gll^Fp, Gll^Fp, Gll^Fp, Ce, Ce, Ce, Ket, Re, Ket, Ce, Ce, Ce, Ww, Ww, Gg, Gg, Gg, Gg, Gg, Gg, Re, Gg, Gg, Gg, Ww, Ww, Gg, Ww, Ww, Gg, Ww, Gg, Gg, Re, Gs^Fms, Gs^Fds, Gs^Fds, Gs^Fds, Gs^Fds, Gs^Fds, Gs^Qhhf, Gs^Qhhf, Gs^Qhhf, Gs^Qhhf, Gs^Fds, Gs^Qhhf, Gs^Qhhf, Gs^Qhhf, Gs^Qhhf, Gs^Fds
Gs, Gll^Fp, Gll^Fp, Gll^Fp, Gll^Fp, Ce, Gll^Fp, Gll^Fp, Re, Re, Rp, Re^Vl, Re^Es, Gll^Fp, Gll^Fp, Ce, Ww, Ce, Ce, Ce, Ce, Ce, Ket, Re, Ket, Ce, Ce, Ce, Ce, Ww, Ww, Ww, Gg, Gg, Ce, Gg, Gg, Re, Re, Gs^Fds, Gs^Fds, Gs^Fds, Gs^Fms, Gs^Fds, Gs^Fds, Gs^Fds, Gs^Fds, Gs^Qhhf, Gs^Fds, Gs^Qhhf, Gs^Qhhf, Gs^Fds, Gs^Fds
Re, Re, Re, Gll^Fp, Re, Ket, Re, Re^Vl, Re^Es, Rp, Ce, Rp^Es, Rb, Re^Vl, Re, Ce, Ww^Bw/, Re, Re, Rb^Edt, Re, Re, Re, Rb, Re^Es, Gs^Fds, Re^Vl, Gs^Fds, Re^Edt, Ce, Ce, Ww, Gg, Ce, Gs^Fds, Ce, Ce, Ce, Re, Ce, Ce, Ce, Ce, Ce, Ce, Gs^Fds, Gg, Gs^Fds, Gs^Fds, Gs^Qhhf, Gs^Qhhf, Gs^Fds, Gs^Fds
Gll^Fp, Gll^Fp, Gll^Fp, Re, Gll^Fp, Re, Re, Re^Es, Gll^Fp, Ce, Ket^Vl, Ce, Re, Rb, Re, Re, Ww, Re, Re^Vl, Re, Re, Re^Vl, Gs^Fds, Rb, Rb, Re^Es, Re, Rb, Rb, Rb, Ww^Bw\, Ww, Ce, Ce, Re^Vl, Gs^Fds, Re, Re, Re^Es, Re^Vl, Re, Re^Vl, Rb^Es, Re, Ce, Gg, Gs^Fds, Gg, Gg, Gg, Gg, Gs^Fds, Gs^Fds
Ww, Gll^Fp, Ww, Gll^Fp, Ww, Ket, Gll^Fp, Re, Re, Ce, Ce, Ce, Re, Re^Vc, Gll^Fp, Ce, Ww, Ce, Gs^Fms, Re, Re, Gs^Fds, Re^Vl, Gs^Fds, Rb, Re^Wm, Re, Re^Vl, Ce, Ce, Ww, Ww^Bw\, Re, Re, Re, Re, Ce, Ce, Ce, Re^Es, Re, Gs^Fds, Rb, Re^Vl, Ket, Gg, Gg, Gs^Fds, Gs^Fds, Gg, Gg, Gs^Fds, Gg
Wo, Ww, Wo, Ww, Wo, Ce, Ce, Re^Vl, Rb, Rb, Rb, Re, Re^Edt, Gll^Fp, Gll^Fp, Ce, Ww, Ce, Ce, Re^Vl, Re, Re, Rp, Rp, Rp, Re, Re^Vl, Gs^Fds, Ce, Ww, Ww, Ce, Gs^Fds, Gs^Fds, Re, Rb, Ce, 3 Ket^Vl, Ce, Rp, Re, Rb, Re, Rb, Re, Gg, Gg, Gs^Fds, Gg, Gg, Gg, Gg, Gg
Wo, Wo, Wo, Wo, Wo, Wo, Wo, Ce, Ce, Ce, Wog^Bw|, Ce, Ce, Ce, Ce, Ce, Ww, Ww, Ww, Ce, Re^Vc, Re^Es, Ce, Ce, Ce, Re, Re, Re, Ce, Ww, Ww, Ce, Ce, Gs^Fds, Re^Vl, Rb, Rb^Es, Ce, Rp, Rp, Re^Vl, Gs^Fds, Re, Re, Ket, Re, Re, Re, Re, Re, Re, Re, Re
Wo, Wo, Wo, Wo, Ww, Wo, Wo, Wo, Wo, Wo, Wo, Wo, Wo, Ww, Wo, Ww, Ww, Ww, Ce, Ce, Re, Re, Ce, Ket^Vl, Ce, Re, Re^Edt, Re^Vl, Gs^Fms, Ce, Ww, Ww, Ww, Ce, Re, Rb, Re^Vl, Re, Re, Re, Re, Re, Re^Vl, Re, Ce, Gg, Gg, Gg, Gg, Gg, Gg, Gg, Gg
Ss, Ss, Ww, Gll^Fp, Gll^Fp, Gll^Fp, Gll^Fp, Wo, Wo, Wo, Ww, Wo, Wo, Wo, Wo, Wo, Wo, Ww, Ce, Gs^Fds, Ce, Re, Re, Ce, Re, Re, Ce, Gs^Fds, Ce, Ce, Ce, Ww, Ww, Ce, Ce, Re, Gs^Fds, Re, Ket, Re, Ket, Re^Edt, Re^Edt, Re, Ce, Gg, Gg, Gg, Gg, Gg, Gg, Gg, Gg
Gll^Fp, Ss, Ww, Ss, Ss^Vhs, Gll^Fp, Gll^Fp, Ww, Ww, Ww, Ww, Ww, Gll^Fp, Wo, Ww, Wo, Wo, Wo, Wo, Ce, Wo, Ce, Wog^Bw|, Re, Wog^Bw|, Ce, Ww, Ce, Ww, Ww, Ww, Ww, Wo, Ww, Ww, Ce, Ce, Ce, Re, Re, Re, Ce, Ce, Ce, Ww, Ww, Ww, Gg, Ww, Gg, Ww, Gg, Ww
Gll^Fp, Ww, Ss, Ss, Gll^Em, Gll^Fp, Ww, Ww, Ss, Ss, Gll^Fp, Gll^Fp, Gll^Fp, Ss, Ss, Ww, Gll^Fp, Wo, Wo, Wo, Wo, Wo, Wo, Wog^Bw|, Wo, Ww, Wo, Ww, Wo, Wo, Wo, Wo, Wo, Ww, Wo, Ww, Ww^Es, Ww^Es, Ww^Bw|, Ww^Bw|, Ww^Bw|, Ww^Es, Ww^Es, Ww, Wo, Wo, Wo, Ww, Wo, Ww, Wo, Ww, Wo
Gll^Fp, Gll^Fp, Gll^Fp, Gll^Fp, Gll^Em, Ww, Ss, Ss^Vhs, Gll^Fp, Gll^Em, Gll^Fp, Gll^Fp, Gll^Qhuf, Ss, Gll^Fp, Gll^Fp, Gll^Fp, Ww, Ww, Wo, Ww, Wo, Wo, Wo, Wo, Wo, Wo, Wo, Wo, Wo, Wo, Wo, Wo, Wo, Wo, Wo, Ww, Ww^Es, Re, Ce, Re, Ww^Es, Ww, Wo, Wo, Wo, Wo, Wo, Wo, Wo, Wo, Wo, Wo
Gll^Fp, Gll^Fp, Ss, Ss, Ss, Ww, Ss, Gll^Fp, Gll^Em, Gll^Em, Gll^Em, Gll^Qhuf, Gll^Qhuf, Gll^Fp, Gll^Fp, Gll^Fp, Ss, Ww, Gll^Fp, Gll^Fp, Gll^Fp, Gll^Fp, Ww, Wo, Gll^Fp, Wo, Gll^Fp, Ww, Gll^Fp, Ww, Gll^Fp, Wo, Ww, Ww, Ww, Wo, Ww, Ww^Es, Ww^Bw|, Ww^Bw|, Ww^Bw|, Ww^Es, Wo, Wo, Ww, Ww, Ww, Ww, Ww, Ww, Ww, Wo, Ww
Gll^Fp, Gll^Fp, Ss, Gll^Fp, Ww, Ss, Gll^Fp, Gll^Fp, Ss^Vhs, Gll^Fp, Ss, Gll^Fp, Gll^Fp, Gll^Fp, Gll^Vhs, Gll^Fp, Ss, Ww, Ss, Gll^Fp, Ss, Ww, Ss, Gll^Fp, Gll^Fp, Gll^Fp, Gll^Fp, Gll^Fp, Gll^Fp, Gll^Fp, Gll^Fp, Gll^Fp, Gll^Fp, Gll^Fp, Gll^Fp, Gll^Fp, Gll^Fp, Gll^Fp, Re, Re, Re, Gll^Fp, Gll^Fp, Gll^Fp, Gll^Fp, Gll^Fp, Gll^Fp, Gll^Fp, Gll^Fp, Gll^Fp, Gll^Fp, Ww, Gll^Fp
Ww, Ww, Ww, Ww, Ss, Gll^Fp, Gll^Qhuf, Gll^Fp, Gll^Fp, Ss, Ww, Ss, Ww, Ss, Ss, Gll^Em, Ww^Bw\, Ww, Gll^Em, Gll^Fp, Ss, Ww, Ss, Ss, Gll^Fp, Gll^Fp, Gll^Fp, Gll^Fp, Gll^Es, Gll^Fp, Gll^Fp, Gll^Fp, Gll, Gll^Fp, Gll^Fp, Gll^Fp, Ce, Gll^Fp, Re^Edt, Re, Re^Edt, Gll^Fp, Ce, Gll^Fp, Gll^Fp, Gll^Fp, Gll^Qhuf, Gll^Fp, Gll^Qhuf, Gll^Fp, Gll^Fp, Gll^Fp, Gll^Fp
Gll^Fp, Gll^Fp, Ss, Gll^Fp, Ss, Gll^Em, Gll^Qhuf, Gll^Qhuf, Gll^Fp, Ss, Ss, Ww, Ss, Ww, Ww, Ww, Ss, Gll^Em, Ss, Gll^Em, Gll^Em, Ss, Gll^Em, Gll^Em, Gll^Fp, Gll^Vhs, Gll^Fp, Gll^Es, Gll^Qhuf, Gll^Es, Gll^Qhuf, Gll^Es, Gll^Fp, Gll^Fp, Gll^Fp, Ce, 1 Ke, Ce, Re^Edt, Re^Ecf, Re^Edt, Ce, 2 Ke, Ce, Gll^Qhuf, Gll^Fp, Gll^Qhuf, Gll^Qhuf, Gll^Fp, Gll^Qhuf, Gll^Qhuf, Gll^Fp, Gll^Fp
Gll^Qhuf, Gll^Fp, Gll^Fp, Ss, Gll^Em, Gll^Em, Gll^Fp, Ss, Ss, Gll^Fp, Gll^Fp, Gll^Fp, Gll^Fp, Ss, Gll^Fp, Gll^Fp, Ss, Ss, Gll^Fp, Gll^Em, Ss, Ss^Bw\, Gll^Em, Gll^Fp, Gll^Fp, Gll^Fp, Gll^Fp, Gll^Qhuf, Gll^Fp, Gll^Qhuf, Gll^Fp, Gll^Fp, Gll^Fp, Gll^Qhuf, Gll^Fp, Ce, Ce, Ce, Re, Re, Re, Ce, Ce, Ce, Gll^Qhuf, Gll^Qhuf, Gll^Fp, Gll^Fp, Gll^Fp, Gll^Fp, Gll^Qhuf, Gll^Qhuf, Gll^Qhuf
Gll^Qhuf, Gll^Qhuf, Gll^Fp, Gll^Fp, Gll^Fp, Gll^Fp, Gll^Fp, Gll^Fp, Ss, Gll^Fp, Gll^Fp, Gll^Fp, Gll^Qhuf, Gll^Fp, Gll^Es, Gll^Es, Gll^Es, Gll^Fp, Gll^Fp, Gll^Fp, Gll^Fp, Gll^Fp, Gll^Fp, Gll^Fp, Gll^Fp, Gll^Qhuf, Gll^Qhuf, Gll^Qhuf, Gll^Fp, Gll^Fp, Gll^Qhuf, Gll^Fp, Gll^Qhuf, Gll^Fp, Gll^Fp, Gll^Fp, Gll^Fp, Re^Ecf, Re^Vct, Re^Vct, Re^Vct, Re^Ecf, Gll^Qhuf, Gll^Qhuf, Gll^Qhuf, Gll^Qhuf, Gll^Fp, Gll^Fp, Gll^Fp, Gll^Fp, Gll^Fp, Gll^Fp, Gll^Fp
Gll^Qhuf, Gll^Fp, Gll^Fp, Gll^Fp, Gll^Fp, Gll^Fp, Gll^Fp, Gll^Fp, Gll^Fp, Ss, Gll^Fp, Gll^Qhuf, Gll^Fp, Gll^Qhuf, Gll^Qhuf, Gll^Qhuf, Gll^Fp, Gll^Fp, Gll^Qhuf, Gll^Qhuf, Gll^Fp, Gll^Fp, Gll^Fp, Gll^Fp, Gll^Fp, Gll^Qhuf, Gll^Fp, Gll^Fp, Gll^Qhuf, Gll^Fp, Gll^Qhuf, Gll^Qhuf, Gll^Qhuf, Gll^Fp, Gll^Fp, Gll^Fp, Gll^Fp, Gll^Edt, Re, Re^Vct, Re, Gll^Edt, Gll^Fp, Gll^Qhuf, Gll^Fp, Gll^Fp, Gll^Qhuf, Gll^Fp, Gll^Fp, Gll^Fp, Gll^Fp, Gll^Qhuf, Gll^Fp
Gll^Fp, Gll^Fp, Gll^Fp, Gll^Fp, Gll^Fp, Gll^Fp, Gll^Fp, Gll^Fp, Gll^Fp, Gll^Fp, Gll^Fp, Gll^Fp, Gll^Fp, Gll^Fp, Gll^Fp, Gll^Fp, Gll^Fp, Gll^Fp, Gll^Qhuf, Gll^Qhuf, Gll^Qhuf, Gll^Qhuf, Gll^Qhuf, Gll^Fp, Gll^Fp, Gll^Fp, Gll^Fp, Gll^Fp, Gll^Fp, Gll^Qhuf, Gll^Qhuf, Gll^Qhuf, Gll^Fp, Gll^Fp, Gll^Fp, Gll^Fp, Re, Gll^Fp, Re, Re, Re, Gll^Fp, Gll^Fp, Gll^Fp, Gll^Fp, Gll^Fp, Gll^Fp, Gll^Fp, Gll^Fp, Gll^Fp, Gll, Gll^Fp, Gll^Fp
