Gg, Gg, Re, Gs, Gg, Ww, Ww, Gg, Gg, Gg^Efm, Gg^Efm, Gs, Gs^Qhhf, Gs^Fds, Gs^Fds, Gs^Fds, Gs^Fds, Gs^Fds, Gs^Qhhf, Gs^Qhhf, Gs^Fds, Gs^Fds, Gg, Gg, Gg, Gg, Gg, Gg, Gg^Efm, Gg, Gg, Gg, Gs^Fds, Gs^Fds, Gs^Fds, Gs^Fds, Gs^Fds, Gg, Gg, Re, Gs^Fds, Gs^Fds, Gs^Fds, Gs^Fds, Gs^Fds, Gs, Gg
Gll^Fp, Gg, Gg, Re, Gs^Vl, Ww, Wwf^Es, Gg, Re, Gg^Efm, Gg, Gg, Gs^Fds, Gs^Qhhf, Gs^Qhhf, Gs^Qhhf, Gs^Fds, Gs^Fds, Gg, Gs^Fds, Gg, Gs^Fds, Gs, Gs, Gg, Gg^Efm, Gg, Gg, Gg^Efm, Gg^Efm, Gg, Gg, Gg, Gs^Fds, Gs^Fds, Gs^Fds, Gg, Gg, Re, Re, Gs^Fds, Gs^Fds, Gs^Fds, Gg^Efm, Gg^Efm, Gg, Gg
Gll^Fp, Gg, Gll^Fp, Re, Re, Re, Wwf^Es, Re, Gg, Re, Re, Re, Re, Gs^Fds, Re, Gg, Re, Gg, Re, Gg, Gs, Gs, Gs, Gg, Gs, Gg, Gs, Gg, Gg, Gs^Fds, Gs^Fds, Gs^Fds, Gg, Gs^Fds, Gs^Fds, Gs^Fds, Gs^Fds, Gg, Re, Gs^Fds, Gs^Fds, Gs^Fds, Gs^Qhhf, Gs^Fds, Gs^Fds, Gs^Fds, Gs^Fds
Gll^Fp, Gll^Fp, Gll^Fp, Gg, Gg^Efm, Gg, Gg, Wwf^Es, Ww, Gg, Gg, Gg, Gg, Re, Gg, Re, Gs, Re, Gs, Re, Re, Ce, Re, Gs, Re, Gs, Re, Ce, Gs, Gs^Fds, Gs^Fds, Gg^Efm, Gg, Gg, Gg, Gs^Fds, Re, Re, Rb^Gvs, Gs^Vl, Gg, Gs^Fds, Gs^Qhhf, Gs^Qhhf, Gs^Qhhf, Gs^Fds, Gs^Qhhf
Gll^Fmw, Gll^Fp, Gll^Fp, Gll^Fp, Gll^Fp, Gll^Fp, Gll^Fp, Gll^Fp, Gll^Fp, Ww, Ww, Gs^Fds, Gs^Qhhf, Gs^Fds, Gs^Qhhf, Gs^Qhhf, Gs^Fds, Gs^Fds, Gs, Gs, Re, Re, Re, Re, Ce, Re^Edt, Re^Edt, Re, Gs, Gs, Re, Re, Re, Re, Re, Re, Rb^Gvs, Rb^Gvs, Rb^Gvs, Rb^Gvs, Gg, Gs^Qhhf, Gg, Gg, Gg, Gs^Qhhf, Gg
Gll^Fp, Gll^Fp, Gll^Fmw, Gll^Fp, Gll^Fmw, Gll^Fp, Gll^Fp, Gll^Fmw, Gll^Fp, Gll^Fp, Gll^Fp, Ww, Gs^Qhhf, Gs^Fds, Gs^Fds, Gs^Fds, Gs^Fds, Ce, Re, Re, Rb^Edt, Re, Re, Ce, 2 Ke, Ce, Re, Re, Re, Gs, Re, Ce, Gg, Gg, Gg, Rb^Gvs, Rb^Gvs, Rb^Gvs, Gs^Fds, Gs^Fds, Gg^Efm, Gg, Gg, Gg^Efm, Gg^Efm, Gg, Gg
Gll^Fp, Gll^Fmw, Gll^Fp, Gll^Fp, Gll^Fmw, Gll^Fp, Gg^Efm, Gll^Fp, Gg, Gll^Fp, Gll^Fp, Ww, Gs^Qhhf, Gs^Fds, Gs^Fds, Gs^Fds, Gs^Fds, Gs^Fds, Gs, Re^Edt, Rb^Edt, Rb^Edt, Rb, Ce, Ce, Ce, Rb^Edt, Re, Rb, Re, Gs, Gs, Gg^Efm, Gg^Efm, Gs^Qhhf, Gs^Qhhf, Gs^Fds, Gs^Fds, Gs^Fds, Gs^Qhhf, Gs^Qhhf, Gg, Gs^Fds, Gg, Gg, Gg, Gg
Gll^Fmw, Gll^Fmw, Gll^Fp, Gll^Fmw, Gll^Fp, Gll^Fp, Gg^Efm, Gg^Efm, Ww, Gll^Fp, Ww, Ww, Gg, Gg, Gs^Fds, Gs^Fds, Gs^Fds, Gs, Gs, Re^Vct, Re^Ecf, Re^Vct, Rb, Re, Re, Rb, Rb^Edt, Re^Vct, Re^Ecf, Re^Vct, Gs, Gg, Gg, Gg^Efm, Gs^Qhhf, Gs^Fds, Gs^Fds, Gs^Fds, Gs^Fds, Gs^Fds, Gs^Fds, Gs^Fds, Gg, Gg, Rb^Gvs, Gg, Gg
Gll^Fp, Gll^Fmw, Gll^Fp, Gll^Fmw, Gll^Fp, Gll^Fp, Gg, Ww, Gg, Ww, Gg, Gg, Gg^Efm, Gg, Gg, Gs^Fds, Gs^Fds, Gs, Re, Re^Vct, Re, Re^Vct, Re, Re, Re, Rb^Edt, Re, Re^Vct, Re^Edt, Re^Vct, Re, Gs, Gg, Gs^Qhhf, Gs^Fds, Gs^Fds, Gg, Gs^Fds, Gs^Qhhf, Gs^Qhhf, Gs^Qhhf, Gs^Fds, Rb^Gvs, Rb^Gvs, Rb^Gvs, Rb^Gvs, Gg
Gll^Fp, Gll^Fp, Gll^Fp, Gll^Fp, Gll^Fp, Gll^Fp, Ww, Ww, Gg, Gg, Gg, Gg^Efm, Gg^Efm, Gg, Gs, Gg, Re, Re, Ce, Re, Ce^Ecf, Re^Edt, Ce, Re, Re, Re, Ce, Re, Ce^Ecf, Re, Ce, Re, Re, Gg, Gs, Gs^Fds, Gg, Gg, Gg, Gg, Gg, Gs^Qhhf, Rb^Gvs, Rb^Gvs, Gs^Vl, Gg, Gg
Gll^Fp, Gll^Fp, Ww, Ww, Ww, Ww, Gg, Gg, Gg^Efm, Gg, Gg, Gg, Gg, Gg, Gs, Re, Ce, Gs, Gg, Ce, Gg, Ce, Gs, Re, Re, Re, Gs, Ce, Gg, Ce, Gg, Gs, Ce, Re, Gs, Gg, Gg^Efm, Gg^Efm, Gg, Gg, Rb^Gvs, Rb^Gvs, Rb^Gvs, Rb^Gvs, Gg, Gg, Gg
Gll^Fp, Gll^Fp, Ww, Gll^Fp, Gll^Fp, Gs^Fds, Gs^Qhhf, Gs^Fds, Gs^Qhhf, Gs^Fds, Gs^Qhhf, Gs^Fds, Gs^Qhhf, Gs^Fds, Re, Re, Gg, Gs, Gg, Gg, Gg, Gg, Gg, Gg, Re, Gs, Gg, Gg, Gg, Gg, Gg, Gg, Gg, Re, Re, Gg, Gg, Gg^Efm, Gg, Gs^Fds, Gs^Fds, Rb^Gvs, Gg, Gg, Wwf, Wwf, Wwf
Ww, Ww, Gll^Fp, Gll^Fp, Gll^Fp, Gs^Fds, Gs^Qhhf, Gs^Fds, Gs^Fds, Gs^Qhhf, Gs^Fds, Gs^Fds, Gs^Qhhf, Re, Ce, Gg, Gg, Gg, Ds, Gg, Ds, Gg, Ds, Gg, Rb^Bw|, Gg, Ds, Ds, Ds, Ds, Ds, Gg, Gg, Gg, Ce, Re, Gs, Gg, Gg, Gs^Fds, Gg, Gg, Gg, Wwf, Wwf, Gs^Qhhf, Gs^Fds
Ww, Ww, Gll^Fp, Gll^Fp, Gll^Fp, Gll^Fp, Gs^Fds, Gs^Qhhf, Gs^Qhhf, Gs^Qhhf, Gs^Qhhf, Gs^Qhhf, Gg, Re, Gg, Gg, Ds, Ds, Wwf, Ds, Wwf, Ds, Wwf, Ds, Wwf^Bw|, Ds, Wwf, Wwf, Wwf, Wwf, Wwf, Ds, Ds, Gg, Gg, Re, Re, Gs, Gg, Gg, Wwf, Wwf, Wwf, Wwf, Gs^Qhhf, Gs^Qhhf, Gs^Fds
Gll^Fp, Gll^Fp, Gll^Fp, Gll^Fp, Gll^Fp, Gll^Fp, Gll^Fp, Gs^Qhhf, Gs^Fds, Gs^Fds, Gll^Fp, Gs^Fds, Re, Re, Gg, Ds, Wwf, Wwf, Ds, Wwf, Ds, Wwf, Ds, Wwf, Ds^Bw|, Wwf, Ds, Ds, Ds, Ds, Ds, Wwf, Wwf, Ds, Gg, Gg, Ce, Gs, Wwf, Wwf, Gg, Gg, Gs^Fds, Gs^Qhhf, Gs^Fds, Gs^Fds, Gs^Fds
Gll^Fp, Gll^Fp, Gll^Fp, Gll^Fp, Gll^Fp, Gll^Fp, Gll^Fp, Gll^Qhuf, Gll^Fp, Gll^Fp, Gg, Gg, Re, Ce, Ds, Ds, Wwf, Ds, Gs, Ds, Gs, Ds, Gs, Ds, Iwr, Ds, Gs, Gs, Gs, Gs, Gs, Ds, Wwf, Ds, Ds, Ds, Ds, Re, Wwf, Gg, Gs^Fds, Gg, Gs^Fds, Gs^Fds, Gs^Fds, Gs^Fds, Gs^Fds
Gll^Fp, Gll^Fp, Gll^Fp, Gll^Fp, Gll^Fp, Gll^Qhuf, Gll^Fp, Gll^Qhuf, Gll^Qhuf, Gll^Qhuf, Gll, Re, Gg, Ds, Wwf, Wwf, Ds, Ds, Gs, Gs, Mm^Fms, Mm^Fms, Mm^Fms, Ket, Iwr, Ket, Mm^Fms, Mm^Fms, Mm^Fms, Gs, Gs, Ds, Wwf, Wwf, Wwf, Wwf, Wwf, Wwf, Gg, Gg, Gs^Fds, Gs^Fds, Gs^Qhhf, Gs^Fds, Gs^Qhhf, Gs^Fds, Gs^Fds
Gll^Fp, Gll^Fp, Gll^Fp, Gll^Qhuf, Gll^Qhuf, Gll^Fp, Gll^Fp, Gll^Em, Gll^Em, Gll, Gll, Ce, Gg, Ds, Wwf, Ds, Gs, Gs, Ket, Ket, Hh, Ket, Hh, Hh, Iwr, Hh, Hh, Ket, Hh, Ket, Ket, Ds, Ds, Wwf, Wwf, Wwf, Ds, Ds, Gg, Gg, Gs^Fds, Gs^Qhhf, Gg, Gs^Qhhf, Gg, Gg, Gg
Gll^Fp, Gll^Fp, Gll^Fp, Gll^Qhuf, Gll^Qhuf, Gll^Qhuf, Gll^Qhuf, Gll^Em, Gll^Fp, Gll^Fp, Gll^Fp, Gg, Ds, Ds, Wwg, Ds, Gs, Gs, Ket, Hh, Rp^Vl, Gs^Fds, Iwr, Iwr, Iwr, Iwr, Iwr, Gs^Fds, Rp^Vl, Hh, Ket, Gs, Ds, Wwf, Wwf, Ds, Ds, Gg, Gg, Gg, Gg, Gg, Gg, Gg, Gg^Efm, Gg, Gg
Gll^Fp, Gll^Fp, Gll^Fp, Gll^Fp, Gll^Fp, Gll^Qhuf, Gll^Qhuf, Gll^Fp, Gll^Fp, Gll^Fp, Gg, Gg, Ds, Wwf, Ds, Ds, Gs, Mm^Fms, Ket, Hh, Gs^Fds, Iwr, Ket, Ket^Ebn, Cv^Bh|, Ket^Ebn, Ket, Iwr, Gs^Fds, Hh, Ket, Mm^Fms, Gs, Ds, Ds, Wwf, Ds, Gg, Gg, Gg^Efm, Gg, Gg, Gg, Gg^Efm, Gg^Efm, Gg^Efm, Gg
Gll^Fp, Gll^Fp, Gll^Fp, Gll^Fp, Gll^Fp, Gll^Qhuf, Gll^Qhuf, Gll^Em, Gll^Em, Gll^Fp, Gll^Fp, Gg, Ds, Wwf, Ds, Gs, Gs, Mm^Fms, Hh, Gs^Fds, Iwr, Iwr, Co^Bh/, Ket^Fp, 3 Ket^Vl, Ket^Fp, Co^Bh\, Iwr, Iwr, Gs^Fds, Hh, Mm^Fms, Gs, Gs, Ds, Wwf, Wwf, Ds, Gg, Gg, Gg, Gg, Gg, Gg, Gs, Gg, Gg
Gll^Fp, Gll^Fp, Gll^Qhuf, Gll^Fp, Gll^Qhuf, Gll^Qhuf, Gll^Fp, Gll^Qhuf, Gll^Em, Gll^Fp, Gll^Fp, Gg, Ds, Wwf, Ds, Gs, Gs, Ket, Hh, Hh, Iwr, Ket^Ebn, Co^Bh\, Ket^Efs, Ket^Bh|, Ket^Efs, Co^Bh/, Ket^Ebn, Iwr, Hh, Hh, Ket, Gs, Gs, Ds, Ds, Wwf, Ds, Gg, Gg, Gg, Gs^Fds, Gs^Qhhf, Gs^Fds, Gs^Fds, Gs^Fds, Gs^Fds
Gll^Fp, Gll^Fp, Gll^Qhuf, Gll^Qhuf, Gll^Qhuf, Gll^Fp, Gll^Fp, Gll^Fp, Gll^Fp, Gll, Gg, Gg, Ds, Wwf, Ds, Gs, Gs, Mm^Fms, Ket, Gs^Fds, Gs^Fds, Iwr, Ket, Ket, Cv^Bh|, Ket, Ket, Iwr, Gs^Fds, Gs^Fds, Ket, Mm^Fms, Gs, Gs, Ds, Wwf, Ds, Ds, Gg, Gg, Gs, Gg, Gs^Qhhf, Gs^Qhhf, Gs^Fds, Gs^Fds, Hh^Fds
Gll^Qhuf, Gll^Qhuf, Gll^Fp, Gll^Fp, Gll^Fp, Gll^Qhuf, Gll^Qhuf, Gll^Fp, Gll^Fp, Gg, Ds, Ds, Wwg, Wwf, Ds, Gs, Gs, Mm^Fms, Ket, Hh, Rp^Vl, Iwr, Iwr, Ket^Ebn, Iwr, Ket^Ebn, Iwr, Iwr, Rp^Vl, Hh, Ket, Mm^Fms, Gs, Ds, Wwf, Wwf, Ds, Gg, Gg, Gs, Ce^Ecf, Gg, Gs^Fds, Gs^Fds, Gg, Gs^Fds, Gs^Fds
Gll^Qhuf, Gll^Qhuf, Gll^Fp, Gll^Fp, Gll^Fp, Gll^Em, Gll, Gll^Em, Gll, Ds, Wwf, Wwf, Wwg, Wwg, Wwf, Ds, Gs, Gs, Ket, Hh, Hh, Gs^Fds, Hh, Iwr, Iwr, Iwr, Hh, Gs^Fds, Gs^Fds, Hh, Ket, Gs, Ds, Ds, Wwg, Ds, Gg, Gg, Gs, Gs, Re, Gg, Gg, Gg, Gg^Efm, Gg, Gg
Gll^Fp, Gll^Fp, Gll^Fp, Gll^Fp, Gll^Fp, Gll^Fp, Gll, Ce, Ds, Ds, Wwg, Wwf, Ds, Wwf, Wwf, Ds, Ds, Gs, Gs, Ket, Mm^Fms, Ket, Mm^Fms, Hh, Iwr, Hh, Mm^Fms, Ket, Mm^Fms, Ket, Gs, Gs, Ds, Wwf, Ds, Ds, Gg, Gs, Ce, Gs, Re, Gg, Gg, Gg^Efm, Gg^Efm, Gg, Gg
Gll^Fp, Gll^Fp, Gll^Fp, Gll^Fp, Gll^Fp, Gll^Fp, Gll^Fp, Ds, Wwg^Fdw, Wwg, Wwg, Ds, Gg, Ds, Ds, Wwf, Ds, Gs, Ds, Gs, Gs, Mm^Fms, Gs, Ket, Iwr, Ket, Gs, Mm^Fms, Gs, Gs, Gs, Gs, Ds, Wwf, Ds, Gg, Gg, Ce, Re, Re, Gg, Gg, Gs^Fds, Gg, Gs^Fds, Gs, Gs^Fds
Wog^Fp, Gll^Fp, Wog^Fp, Wog^Fp, Wog^Fp, Wog^Fp, Wog^Fetd, Wwg^Dr, Wwg^Fdw, Wwg, Ds, Ds, Gg, Gg, Ds, Wwf, Wwf, Ds, Wwf, Ds, Ds, Gs, Ds, Gs, Re^Bw|, Gs, Ds, Ds, Ds, Ds, Ds, Ds, Wwf, Wwf, Ds, Gg, Gg, Ce, Re, Gg, Gs^Fds, Gs^Fds, Gs^Fds, Gs^Fds, Gs^Fds, Gs^Fds, Gs^Fds
Wog, Wog^Fp, Wog, Wog, Wog, Wog, Wog^Fetd, Wwg^Dr, Ds, Ds, Gg, Ce, Re, Gg, Gg, Ds, Ds, Wwf, Ds, Wwf, Wwf, Ds, Wwf, Ds, Wwf^Bw|, Ds, Wwf, Wwf, Wwf, Wwg, Wwf, Wwf, Ds, Ds, Gg, Gg, Gg, Gg, Re, Gg, Gs^Fds, Gs^Fds, Gs^Fds, Gs^Fds, Gs^Fds, Gs^Fds, Gs^Fds
Wog^Fp, Wog, Wog^Fp, Wog, Wog^Fp, Wog^Fp, Gll^Fp, Gll^Fp, Gll^Fp, Gll^Fp, Re^Vl, Gg, Re, Gg, Ce^Ecf, Gg, Gg, Ds, Gg, Ds, Ds, Wwf, Ds, Wwf, Ds^Bw|, Wwf, Ds, Ds, Ds, Ds, Ds, Ds, Gg, Gg, Re, Re, Re, Ce, Re, Gg, Gg, Gg, Gg, Gs^Fds, Gg, Gs^Fds, Gs
Gll^Fp, Wog^Fp, Gll^Fp, Wog^Fp, Gll^Fp, Gll^Fms, Gll^Fp, Gll^Fp, Rb^Gvs, Rb^Gvs, Rb^Gvs, Rb^Gvs, Gg, Re, Re, Gs, Gs, Gg, Gg^Efm, Gg, Gg, Ds, Gg, Ds, Re, Ds, Gg, Gg, Gg, Gg, Gg^Efm, Gg, Gs, Gs, Re, Ce^Ecf, Gg, Re, Gs, Gs, Gg^Efm, Gg^Efm, Gg, Gg, Gg, Gg, Gg
Gll^Fp, Gll^Fp, Gll^Fp, Gll^Fp, Gll^Fp, Gll^Fp, Gll^Fp, Gll^Fp, Rb^Gvs, Rb^Gvs, Gll^Qhuf, Gll^Fp, Gll^Fp, Gg, Gg, Re, Re, Gs, Gs, Gg, Gs, Gg, Gg, Gg, Re, Gg, Gs, Gs, Gs, Gg, Gg, Gg, Gs, Gs, Re, Gg, Gg, Gg, Gg, Gg, Gg, Gg, Gs^Qhhf, Gg, Gs^Fds, Gs^Fds, Gs^Fds
Gll^Qhuf, Gll^Fp, Gll^Qhuf, Gll^Qhuf, Gll^Fp, Gll^Fp, Gll^Fp, Gll^Fp, Gll^Fp, Gll^Fp, Gll^Qhuf, Gll, Gll^Qhuf, Gg, Gg, Ce, Re, Gs, Ce, Ce, Ce^Ecf, Ce, Ce, Re, Re, Re, Ce, Ce, Ce^Ecf, Ce, Ce, Gg, Re, Ce, Re, Gg, Gg^Efm, Gg, Gs^Qhhf, Gs^Qhhf, Gs^Qhhf, Gs^Qhhf, Gs^Qhhf, Gs^Fds, Gs^Qhhf, Gs^Fds, Gs^Fds
Gll^Qhuf, Gll^Qhuf, Gll^Qhuf, Gll^Fp, Gll^Fp, Gll^Fp, Gll^Qhuf, Gll^Fp, Gll^Qhuf, Gll^Qhuf, Gll^Fp, Gll^Qhuf, Gll^Em, Gg, Gg, Gs, Gs, Re, Re, Re, Re^Edt, Re^Edt, Re, Re, Re, Re, Re, Re, Re, Re, Re, Re, Gs, Re, Gg, Gg, Gg, Gs^Qhhf, Gs^Fds, Gs^Fds, Gs^Fds, Gs^Fds, Gs^Qhhf, Gs^Qhhf, Gs^Qhhf, Gs^Qhhf, Gs^Qhhf
Gll^Qhuf, Gll^Qhuf, Gll^Qhuf, Gll^Fp, Gll^Fp, Gll^Fp, Gll^Fp, Gll^Qhuf, Gll^Qhuf, Gll^Fp, Gll^Fp, Gll^Em, Gll^Fp, Gll, Gll^Fp, Gg, Gll^Fp, Gs, Re^Edt, Re^Vct, Re^Ecf, Re^Vct, Rb, Rb, Rb, Rb, Rb^Edt, Re^Vct, Re^Ecf, Re^Vct, Re, Gs, Gg, Gg, Gs^Qhhf, Gg, Gs^Qhhf, Gs^Qhhf, Gs^Fds, Gs^Fds, Gs^Fds, Gs^Fds, Gs^Qhhf, Gs^Qhhf, Gs^Fds, Gs^Qhhf, Gs^Qhhf
Gll^Fp, Gll^Fp, Gll^Fp, Gll^Fp, Gll^Fp, Gll^Fp, Gll^Fp, Gll^Fp, Gll^Fp, Gll^Fp, Gll^Fp, Gll^Fp, Gll^Fp, Gll^Em, Gll^Fp, Gll^Fp, Gll^Fp, Gs, Re, Re^Vct, Re^Edt, Re^Vct, Re, Re, Ce, Re^Edt, Re^Edt, Re^Vct, Re^Edt, Re^Vct, Re, Gs, Gg, Gg, Gs^Fds, Gs^Qhhf, Gs^Fds, Gs^Fds, Gs^Fds, Gs^Fds, Gs^Fds, Gs^Fds, Gs^Fds, Gs^Qhhf, Gg^Qhhf, Gs^Qhhf, Gs^Qhhf
Gll^Fp, Gll^Fp, Gll^Fp, Gll^Fp, Gll^Em, Gll^Fp, Gll^Em, Gll^Fp, Gll^Fp, Gll^Qhuf, Gll^Qhuf, Gll^Fp, Gll^Fp, Gll^Qhuf, Gll^Qhuf, Gll^Fp, Gll, Gll, Gs, Gs, Re, Re^Edt, Re, Ce, 1 Ke, Ce, Re, Re^Edt, Re, Gs, Gg, Gg, Gg, Gs^Fds, Gs^Fds, Gs^Fds, Gs^Fds, Gs^Fds, Rb^Gvs, Gs^Fds, Re, Gs^Vl, Gg, Gs^Fds, Gs^Fds, Gs^Qhhf, Gs^Qhhf
Gll^Fp, Gll^Fp, Gll^Fp, Gll^Fp, Gll, Gll, Gll^Fp, Gll^Fp, Gll^Fp, Gll^Fp, Gll^Fp, Gll^Qhuf, Gll^Qhuf, Gll^Qhuf, Gll^Fp, Gll^Qhuf, Gll^Qhuf, Ce, Re, Gs, Re, Gs, Re, Ce, Ce, Ce, Re, Gs, Gs, Gg, Re, Ce, Gg, Gg, Gg, Gg, Rb^Gvs, Rb^Gvs, Rb^Gvs, Rb^Gvs, Rb^Gvs, Gs^Qhhf, Gs^Fds, Gs^Fds, Gs^Fds, Gs^Fds, Gs^Fds
Gll^Fp, Gll^Fp, Gll^Fp, Gll^Vl, Gll^Fp, Gll^Em, Gll^Fp, Gll^Fp, Gll^Fp, Gll^Fp, Gll^Qhuf, Gll^Qhuf, Gll^Qhuf, Gll^Fp, Gll^Qhuf, Gll^Qhuf, Gll, Gll, Re, Re, Re, Gs, Re^Edt, Rb^Edt, Rb, Rb, Re, Gs, Re, Re, Gg, Gg, Gs^Qhhf, Gs^Fds, Gs, Rb^Gvs, Rb^Gvs, Rb^Gvs, Rb^Gvs, Rb^Gvs, Gs^Qhhf, Gs^Qhhf, Gs^Fds, Gs^Fds, Gs^Fds, Gs^Fds, Gs^Fds
Gll^Fp, Gll^Fp, Gll^Fp, Gll^Fp, Gll^Fp, Gll^Fp, Gll^Fp, Gll^Fp, Gll^Fp, Gll^Qhuf, Gll^Qhuf, Gll^Qhuf, Gll^Fp, Gll^Fp, Gll^Fp, Gll^Fp, Gll^Fp, Gll^Fp, Gg, Gg, Gg, Ce, Re, Re^Edt, Re, Re^Edt, Re, Ce, Gg, Gs^Fds, Gs^Fds, Gs^Qhhf, Gs^Fds, Gs^Fds, Gs^Fds, Gs^Fds, Gs^Fds, Gs^Fds, Gs^Fds, Gs^Fds, Gs^Fds, Gs^Fds, Gs^Fds, Gs^Fds, Gs^Fds, Gs^Fds, Gs^Fds
Gs, Gll^Fp, Gs, Gll^Fp, Gs, Gll^Fp, Gll^Fp, Gll^Fp, Gll^Qhuf, Gll^Qhuf, Gs, Gll^Fp, Gll^Fp, Gll^Fp, Gll^Fp, Gll^Fp, Gll^Fp, Gll^Fp, Gg, Gg, Gg, Gg, Gs, Re, Re, Re, Gs, Gg, Gs^Fds, Gs^Fds, Gs^Fds, Gs^Fds, Gs^Fds, Gs^Fds, Gs, Gs^Fds, Gs, Gs^Fds, Gs, Gs^Fds, Gs, Gs^Fds, Gs, Gs^Fds, Gs^Fds, Gs^Fds, Gs^Fds
