Gs, Gs, Re, Gs, Gg^Gvs, Wwg, Wwg, Gs, Gs, Gs, Gs^Gvs, Gs, Gs^Fds, Gs^Fds, Gs^Fds, Gs^Fds, Gs^Fds, Gs^Fds, Gs^Fds, Gs^Fds, Gs^Fds, Gs^Fds, Gs, Gs, Gs, Gg, Gg^Efm, Gg, Gg^Efm, Gg, Gg, Gs, Hh^Fds, Hh^Fds, Hh^Fds, Hh^Fds, Hh^Fds, Gs, Gg, Re, Gg, Gg, Gg^Efm, Gs, Gg^Efm, Gs, Gg
Gll^Fp, Gs, Gs, Re, Gs^Vl, Wwg, Wwf, Gg, Re, Gs, Gs^Gvs, Gs^Gvs, Gs^Fds, Gs^Fds, Gs^Fds, Gs^Fds, Gs^Fds, Gs^Fds, Gs^Gvs, Gs^Fds, Gs^Gvs, Gs^Fds, Gs, Gs^Gvs, Gg, Gg, Gg^Efm, Gg^Efm, Gg, Gg^Efm, Gg^Efm, Gs, Gs, Hh^Fds, Hh^Fds, Hh^Fds, Gs, Gs, Re, Re, Gs, Gg^Efm, Gs, Gg^Efm, Gs, Gg, Gs
Gll^Fp, Gs, Gll^Fp, Re, Re, Re, Wwf, Re, Gg, Re, Re, Re, Re, Gs^Fds, Re, Gs, Re, Gs, Re, Gs^Gvs, Gs, Gs, Gs, Gs, Gs, Gs, Gs, Gs, Gs, Gs, Gg^Efm, Gg^Efm, Gs^Gvs, Hh^Fds, Hh^Fds, Hh^Fds, Hh^Fds, Gs, Re, Gs, Hh^Fds, Gs, Hh^Fds, Hh^Fds, Hh^Fds, Hh^Fds, Hh^Fds
Gll^Fp, Gll^Fp, Gll^Fp, Gll^Fp, Gs, Gg, Gg, Wwf, Wwg, Gg, Gg, Gs, Gs, Re, Gs, Re, Gs, Re, Gs, Re, Gll^Edt, Cer, Rb, Re^Edt, Rb, Re, Rb, Cer, Gll^Edt, Gs, Gs, Gg^Gvs, Gg, Gs^Gvs, Gs, Hh^Fds, Re, Re, Gg^Efm, Gs^Vl, Gs, Hh^Fds, Hh^Fds, Hh^Fds, Hh^Fds, Hh^Fds, Hh^Fds
Gll^Fp, Gll^Fp, Gll^Fp, Gll^Fp, Gll^Fp, Gll^Fp, Gll^Fp, Gs^Fds, Gs^Fms, Wwg, Wwg, Gs^Fms, Gs^Fms, Gs^Fds, Gs^Fds, Gs^Fds, Gs^Fds, Gs^Fds, Gll, Re, Re^Edt, Re^Edt, Rb^Edt, Rb, Cer, Rb, Re^Edt, Re^Edt, Gll^Edt, Gs, Re, Re, Re, Re, Re, Re, Gg, Gg^Efm, Gg^Efm, Gg^Efm, Gg^Efm, Gs, Gg^Efm, Gs, Gs, Hh^Fds, Gs
Gll^Fp, Gll^Fp, Gll^Fp, Gll^Fp, Gll^Fp, Gll^Fp, Gll^Fp, Gll^Fp, Gs^Fms, Gs^Fms, Gs^Fms, Wwg, Gs^Fms, Gs^Fms, Gs^Fds, Gs^Fds, Gs^Fds, Cer, Gll^Edt, Re, Re, Rb^Edt, Re, Cer, 2 Ke, Cer, Rb, Rb^Edt, Re, Gll^Edt, Re, Cer, Re, Gg, Gs^Gvs, Gg, Gs, Gs, Gs, Gg^Efm, Gs, Gg, Gg^Efm, Gg^Efm, Gg, Gg, Gs
Gll^Fp, Gll^Fp, Gll^Fp, Gll^Fp, Gll^Fp, Gs^Fms, Gs^Fms, Gll^Fp, Gs^Fms, Gs^Fms, Gs^Fms, Wwg, Gs^Fms, Gs^Fms, Gs^Fms, Gs^Fms, Gs^Fds, Gs^Fds, Gll^Edt, Re^Edt, Re, Re, Re, Cer, Cer, Cer, Re, Re, Re, Re^Edt, Gll^Edt, Re, Gs, Gs^Gvs, Hh^Fms, Hh^Fms, Hh^Fms, Hh^Fms, Hh^Fms, Hh^Fms, Hh^Fms, Gs, Hh^Fms, Gs, Gg^Efm, Gg^Efm, Gs
Gs, Gll^Fp, Gs^Fms, Gll^Fp, Gll^Fp, Gll^Fp, Gs^Fms, Gs^Fms, Wwg, Gs^Gvs, Wwg, Wwg, Gs, Gs^Gvs, Gs^Fms, Gs^Fms, Gs^Fms, Gll, Gll^Edt, Re^Vct, Re^Ecf, Re^Vct, Rb, Rb^Edt, Rb, Rb, Gs, Re^Vct, Re^Ecf, Re^Vct, Gll, Gs, Gs, Gs^Gvs, Hh^Fms, Hh^Fms, Hh^Fms, Hh^Fms, Hh^Fms, Hh^Fms, Hh^Fms, Hh^Fms, Gs, Gs, Gg^Efm, Gg^Efm, Gs
Gll^Fp, Gll^Fp, Gs^Fms, Gs^Fms, Gg, Gg, Gg, Wwg, Gg, Wwg, Gg^Efm, Gg, Gg^Efm, Gg, Gs, Gs^Fms, Gs^Fms, Gll, Re, Re^Vct, Re, Re^Vct, Re, Rb, Re, Rb, Re, Re^Vct, Re, Re^Vct, Re, Gll, Gs, Hh^Fms, Hh^Fms, Hh^Fms, Gs^Gvs, Hh^Fms, Hh^Fms, Hh^Fms, Gs, Gs, Gg, Gg^Efm, Gg, Gg, Gg
Gs, Gs^Fms, Gg^Efm, Gg, Gg, Gg^Efm, Wwg, Wwg, Gg^Efm, Gg^Efm, Gg^Efm, Gg^Efm, Gg, Gg, Gg, Gs^Gvs, Re, Re, Cer, Re, Cer^Ecf, Re, Cer, Re, Re, Re, Cer, Re, Cer^Ecf, Re, Cer, Re, Re, Gs, Gg, Gg^Gvs, Gg, Gg^Gvs, Gg^Efm, Gs, Gg^Efm, Gg, Gs^Gvs, Gg, Gs^Vl, Gg, Gg
Gs, Gg^Efm, Wwg, Wwg, Wwg, Wwg, Gs, Gg, Gs, Gg, Gs, Gg, Gs, Gs, Gs, Re, Cer, Gs, Gs, Cer, Gs, Cer, Gs, Gll, Re, Gll, Gs, Cer, Gs, Cer, Gs, Gs, Cer, Re, Gg, Gs, Gs, Gg^Efm, Gg^Efm, Gg^Efm, Gg^Gvs, Gg^Efm, Gs, Gs^Gvs, Gll, Gll, Gll
Gs, Gg, Wwg, Gg^Efm, Gs, Gs^Fms, Gs^Fms, Gs^Fms, Gs^Fms, Gs^Fms, Gs^Fms, Gs^Fms, Gs^Fms, Gs^Fms, Re, Re, Gs, Gs, Gs, Gs, Gs, Gs, Gs, Gs, Re, Gs, Gs, Gs, Gs, Gs, Gs, Gs, Gs, Re, Re, Gs, Gs, Gs^Gvs, Gs^Gvs, Gs, Gs^Gvs, Gs^Gvs, Gll, Gll, Wwf, Wwf, Wwf
Wwg, Wwg, Gg, Gg, Gg, Gs^Fms, Gs^Fms, Gs^Fms, Gs^Fms, Gs^Fms, Gs^Fms, Gs^Fms, Gs^Fms, Re, Cer, Gs, Gs, Gs, Ds, Gs, Ds, Re, Ds, Gs, Rb^Bw|, Gs, Ds, Ds, Ds, Ds, Ds, Gs, Gs, Gs, Cer, Re, Gs, Gs^Gvs, Gs, Gs, Gll, Gll, Gll, Wwf, Wwf, Gll, Gll
Wwg, Wwg, Gs^Fms, Gg, Gg^Efm, Gs, Gs^Fms, Gs^Fms, Gs^Fms, Gs^Fms, Gs^Fms, Gs^Fms, Gs^Gvs, Re, Gs, Gs, Ds^Esd, Ds^Esd, Wwf, Ds, Wwf, Ds^Esd, Wwf, Ds^Esd, Wwf^Bw|, Ds^Esd, Wwf, Wwf, Wwf, Wwf, Wwf, Ds^Esd, Ds^Esd, Gs, Gs, Re, Re, Gs, Gll, Gll, Wwf, Wwf, Wwf, Wwf, Gll, Gll, Gs
Gll^Fp, Gll^Fp, Gll^Fp, Gs, Gg^Efm, Gs, Gs, Gs^Fms, Gs^Fms, Gs^Fms, Gs^Gvs, Gs^Fms, Re, Re, Gll, Ds, Wwf, Wwf, Ds, Wwf, Ds, Wwf, Ds^Esd, Wwf, Ds^Bw|, Wwf, Ds, Ds, Ds, Ds^Esd, Ds^Esd, Wwf, Wwf, Ds^Esd, Gll, Gs, Cer, Gll, Wwf, Wwf, Gll, Gll, Gll, Gll, Gs, Gs, Gs^Fds
Gll^Fp, Gll^Fp, Gs^Fms, Gs, Gg, Gg^Efm, Gg, Gs, Gg, Gs, Gs, Gs, Re, Cer, Ds, Ds^Esd, Wwf, Ds, Gs, Ds, Gs, Ds, Gs, Ds^Esd, Re, Ds, Gs, Gs, Gs, Gs, Gs, Ds^Esd, Wwf, Ds^Esd, Ds, Ds, Ds, Re, Wwf, Gll, Gs^Fds, Gs, Gs^Fds, Gs^Fds, Gs^Fds, Gs^Fds, Gs^Fds
Gs^Fms, Gs^Fms, Gs^Fms, Gs, Gs^Fms, Gg, Gs^Fms, Gg, Gs^Fms, Gg, Gs, Re, Gs, Ds, Wwf, Wwf, Ds^Esd, Ds^Esd, Gs, Gs, Mm^Fms, Mm^Fms, Mm^Fms, Ket, Rp, Ket, Mm^Fms, Mm^Fms, Mm^Fms, Gs, Gs, Ds, Wwf, Wwf, Wwg, Wwf, Wwf, Wwf, Gll, Gll, Gs^Fds, Gs^Fds, Gs^Fds, Gs^Fds, Gs^Fds, Gs^Fds, Gs^Fds
Gs^Fms, Gs^Fms, Gs^Fms, Gs^Fms, Gs^Fms, Gs^Fms, Gs^Fms, Gs^Fms, Gs^Fms, Gs^Gvs, Gs^Gvs, Cer, Gll, Ds, Wwf, Ds, Gs, Gs, Ket, Ket, Hh, Ket, Hh, Hh, Rp, Hh, Hh, Ket, Hh, Ket, Ket, Ds, Ds^Esd, Wwg, Wwg, Wwf, Ds, Ds, Gs, Gs, Gs^Fds, Gs^Fds, Gs^Gvs, Gs^Fds, Gs, Gg, Gg
Gs^Fms, Gs^Fms, Gll^Fp, Gs^Fms, Gll^Fp, Gll^Fp, Gs^Fms, Gll^Fp, Gs^Fms, Gs^Fms, Gs^Fms, Gs, Ds, Ds^Esd, Wwg, Ds, Gs, Gs, Ket, Hh, Rp^Vl, Gll^Fp, Rp, Rp, Rp, Rp, Rp, Gll^Fp, Rp^Vl, Hh, Ket, Gs, Ds, Wwf, Wwf, Ds, Ds, Gs, Gs^Gvs, Gs^Gvs, Gs, Gg^Gvs, Gg, Gs, Gg^Efm, Gg^Efm, Gg
Gll^Fp, Gs^Fms, Gll^Fp, Gs^Fms, Gll^Fp, Gll^Fp, Gll^Fp, Gs^Fms, Gs^Fms, Gs^Fms, Gs, Gs, Ds, Wwf, Ds, Ds, Gs, Mm^Fms, Ket, Hh, Gll^Fp, Rp, Ket, Ket^Ebn, Cv^Bh|, Ket^Ebn, Ket, Rp, Gll^Fp, Hh, Ket, Mm^Fms, Gs, Ds, Ds^Esd, Wwf, Ds, Gll, Gs^Gvs, Gs^Gvs, Gs, Gs^Gvs, Gg, Gg^Efm, Gg^Efm, Gg^Efm, Gg
Gll^Fp, Gll^Fp, Gll^Fp, Gll^Fp, Gll^Fp, Gll^Fp, Gll^Fp, Gll^Fp, Gs^Fms, Gs^Fms, Gs, Gs, Ds^Esd, Wwf, Ds, Gs, Gs, Mm^Fms, Hh, Gll^Fp, Rp, Rp, Co^Bh/, Ket^Fp, 3 Ket^Vl, Ket^Fp, Co^Bh\, Rp, Rp, Gll^Fp, Hh, Mm^Fms, Gs, Gs, Ds^Esd, Wwf, Wwf, Ds, Gs, Gs^Gvs, Gs, Gs, Gs, Gg, Gs, Gg, Gg
Gll^Fp, Gll^Fp, Gll^Fp, Gll^Fp, Gll^Fp, Gll^Fp, Gll^Fp, Gs^Fms, Gll^Fp, Gs^Fms, Gs, Gs, Ds^Esd, Wwf, Ds^Esd, Gs, Gs, Ket, Hh, Hh, Rp, Ket^Ebn, Co^Bh\, Ket^Efs, Ket^Bh|, Ket^Efs, Co^Bh/, Ket^Ebn, Rp, Hh, Hh, Ket, Gs, Gs, Ds^Esd, Ds^Esd, Wwf, Ds, Gs, Gs, Gs, Gs^Fds, Hh^Fms, Gs^Fds, Hh^Fms, Hh^Fms, Hh^Fms
Gll^Fp, Gll^Fp, Gll^Fp, Gll^Fp, Gll^Fp, Gll^Fp, Gll^Fp, Gll^Fp, Gs^Fms, Gs^Fms, Gs, Gll, Ds^Esd, Wwf, Ds, Gs, Gs, Mm^Fms, Ket, Gll^Fp, Gll^Fp, Rp, Ket, Ket, Cv^Bh|, Ket, Ket, Rp, Gll^Fp, Gll^Fp, Ket, Mm^Fms, Gs, Gs, Ds^Esd, Wwf, Ds^Esd, Ds, Gs^Gvs, Gs, Gs, Gs^Gvs, Gs^Fds, Hh^Fms, Hh^Fms, Hh^Fms, Hh^Fds
Gll^Fp, Gll^Fp, Gll^Fp, Gll^Fp, Gll^Fp, Gll^Fp, Gll^Fp, Gs^Fms, Gs^Fms, Gs, Ds, Ds, Wwg, Wwf, Ds, Gs, Gs, Mm^Fms, Ket, Hh, Rp^Vl, Rp, Rp, Ket^Ebn, Rp, Ket^Ebn, Rp, Rp, Rp^Vl, Hh, Ket, Mm^Fms, Gs, Ds^Esd, Wwf, Wwf, Ds, Gs, Gs^Gvs, Gs^Gvs, Cer^Ecf, Re, Gs^Fds, Hh^Fds, Gs, Hh^Fms, Gs^Fds
Gll^Fp, Gll^Fp, Gll^Fp, Gll^Fp, Gll^Fp, Gll^Fp, Gll^Fp, Gs^Fms, Gs, Ds, Wwf, Wwf, Wwg, Wwg, Wwf, Ds, Gs, Gs, Ket, Hh, Hh, Gll^Fp, Hh, Rp, Rp, Rp, Hh, Gll^Fp, Gll^Fp, Hh, Ket, Gs, Ds^Esd, Ds^Esd, Wwg, Ds, Gll, Gs, Gs, Gs, Re, Re, Gg, Gs, Gg^Efm, Gg, Gg
Gll^Fp, Gll^Fp, Gll^Fp, Gll^Fp, Gll^Fp, Gll^Fp, Gll^Fp, Cer, Ds, Ds, Wwg, Wwf, Ds, Wwf, Wwf, Ds, Ds^Esd, Gs, Gs, Ket, Mm^Fms, Ket, Mm^Fms, Hh, Rp, Hh, Mm^Fms, Ket, Mm^Fms, Ket, Gs, Gs, Ds^Esd, Wwf, Ds^Esd, Ds, Gs, Gs, Cer, Re, Gs^Gvs, Gs^Gvs, Gs, Gg^Efm, Gg, Gg^Efm, Gg
Gll^Fp, Gll^Fp, Gll^Fp, Gll^Fp, Gll^Fp, Gll^Fp, Gll^Fp, Ds, Wwg^Fdw, Wwg, Wwg, Ds, Gs, Ds, Ds, Wwf, Ds^Esd, Gs, Ds, Gs, Gs, Mm^Fms, Gs, Ket, Rp, Ket, Gs, Mm^Fms, Gs, Gs, Gs, Gs, Ds^Esd, Wwf, Ds, Gll, Gs, Cer, Re, Re, Gs, Gs^Gvs, Gs^Fds, Gs, Hh^Fds, Gs, Gs^Fds
Wog^Fp, Gll^Fp, Wog^Fp, Wog^Fp, Wog^Fp, Wog^Fp, Wog^Fetd, Wwg^Dr, Wwg^Fdw, Wwg, Ds, Ds, Gs, Gll, Ds, Wwf, Wwf, Ds, Wwf, Ds, Ds, Gs, Ds^Esd, Gs, Re^Bw|, Gs, Ds^Esd, Ds^Esd, Ds^Esd, Ds, Ds, Ds, Wwf, Wwf, Ds, Gs, Gs, Cer, Re, Re, Gs^Fds, Hh^Fms, Hh^Fms, Hh^Fms, Hh^Fms, Hh^Fds, Hh^Fms
Wog, Wog^Fp, Wog, Wog, Wog, Wog, Wog^Fetd, Wwg^Dr, Ds, Ds, Re, Cer, Re, Gs, Gs, Ds^Esd, Ds^Esd, Wwf, Ds^Esd, Wwf, Wwf, Ds^Esd, Wwf, Ds^Esd, Wwf^Bw|, Ds, Wwf, Wwf, Wwf, Wwg, Wwf, Wwf, Ds, Ds, Gs, Gs, Gll, Gll, Re, Re, Gs^Fds, Gs^Fds, Gs^Fds, Hh^Fms, Hh^Fms, Hh^Fms, Hh^Fms
Wog^Fp, Wog, Wog^Fp, Wog, Wog^Fp, Wog^Fp, Gll^Fp, Gs^Fms, Gs^Fms, Gs^Fms, Gs^Vl, Re, Gs, Re, Cer^Ecf, Gs, Gs, Ds^Esd, Gll, Ds^Esd, Ds, Wwf, Ds^Esd, Wwf, Rb^Bw|, Wwf, Ds, Ds^Esd, Ds^Esd, Ds^Esd, Ds, Ds, Gs, Gs, Gs, Gll, Gs, Cer, Re, Gs^Gvs, Gs^Gvs, Gs, Gg, Gs^Fds, Gs, Hh^Fms, Gs
Gll^Fp, Wog^Fp, Gll^Fp, Wog^Fp, Gll^Fp, Gs^Fms, Gll^Fp, Gs^Fms, Gll^Fp, Gs^Fms, Gg, Gg, Gs^Fms, Re, Re, Gs, Gs, Gs, Gs, Gs, Gs, Ds, Gs, Ds^Esd, Re, Ds, Gs, Gll, Gs, Gll, Gs, Gs, Gs, Gs, Gs, Cer^Ecf, Re, Re, Gs, Gs^Gvs, Gg^Efm, Gg^Efm, Gg^Efm, Gg^Efm, Gg^Efm, Gg, Gg
Gll^Fp, Gll^Fp, Gll^Fp, Gll^Fp, Gll^Fp, Gll^Fp, Gll^Fp, Gll^Fp, Gs^Fms, Gs^Fms, Gs^Fms, Gs^Fms, Gll^Fp, Gg, Re, Gs, Gs, Gll, Gs, Gs, Gll, Gs, Gll, Gs, Re, Gs, Gll, Gs, Gll, Gs, Gll, Gs, Gs, Gs, Re, Re, Re, Re, Gg, Gg^Efm, Gg, Gg^Efm, Gs^Fds, Gs, Gs^Fds, Gg^Fds, Gs^Fds
Gll^Fp, Gll^Fp, Gll^Fp, Gll^Fp, Gll^Fp, Gll^Fp, Gll^Fp, Gll^Fp, Gll^Fp, Gll^Fp, Gll^Fp, Gll^Fp, Gs^Fms, Gs^Fms, Re, Cer, Re, Gs, Cer, Cer, Cer^Ecf, Cer, Cer, Gll, Re, Gll, Cer, Cer, Cer^Ecf, Cer, Cer, Gs, Re, Cer, Re, Gs, Gs^Gvs, Gs, Gs^Fds, Gs^Fds, Hh^Fms, Gs^Fds, Hh^Fms, Hh^Fds, Hh^Fds, Hh^Fds, Gs^Fds
Gll^Tf, Gll^Tf, Gll^Tf, Gll^Tf, Gll^Tf, Gll^Tf, Gll^Fp, Gll^Fp, Gll^Fp, Gll^Fp, Gs^Fms, Gll^Fp, Gs^Fms, Gg, Gg, Re, Gs, Re, Re, Re, Re, Re, Re, Re, Re, Re, Re, Re, Re, Re, Re, Re, Gll, Re, Gs, Gs^Gvs, Gs^Gvs, Gs^Fds, Hh^Fms, Hh^Fms, Hh^Fms, Hh^Fms, Hh^Fms, Hh^Fms, Hh^Fms, Hh^Fds, Gs^Fds
Gll^Tf, Gll^Tf, Gll^Tf, Gll^Tf, Gll^Tf, Gll^Fp, Gll^Fp, Gll^Fp, Gs^Fms, Gll^Fp, Gll^Fp, Gs^Fms, Gs^Fms, Gs^Fms, Gg, Gs, Gs^Fds, Gll, Gll^Edt, Re^Vct, Re^Ecf, Re^Vct, Rb, Rb, Rb, Rb, Rb, Re^Vct, Re^Ecf, Re^Vct, Gll, Gll, Gs, Gs, Gs^Fds, Gs, Gs^Fds, Hh^Fds, Hh^Fds, Hh^Fms, Hh^Fms, Hh^Fms, Hh^Fms, Hh^Fms, Hh^Fms, Hh^Fms, Hh^Fms
Gll^Fp, Gll^Fp, Gll^Fp, Gll^Fp, Gll^Fp, Gll^Fp, Gll^Fp, Gs^Fms, Gs^Fms, Gll^Fp, Gs^Fms, Gg, Gg, Gg, Gs^Fms, Gs^Fms, Gs^Fms, Gll, Gll^Edt, Re^Vct, Re, Re^Vct, Re, Rb^Edt, Cer, Rb, Re, Re^Vct, Re, Re^Vct, Gll^Edt, Gs, Gs^Gvs, Gs^Gvs, Gs^Fds, Hh^Fds, Hh^Fds, Hh^Fds, Hh^Fds, Hh^Fms, Hh^Fds, Hh^Fds, Gg^Fds, Hh^Fds, Gg^Fds, Hh^Fds, Gs^Fds
Gll^Fp, Gll^Fp, Gs^Fms, Gll^Fp, Gs^Fms, Gll^Fp, Gll^Fp, Gll^Fp, Gll^Fp, Gs^Fms, Gg^Efm, Gg, Gs, Gs^Fms, Gs^Fms, Gll^Fp, Gs^Fds, Gs^Fds, Gll^Edt, Re^Edt, Re, Re, Re, Cer, 1 Ke, Cer, Rb, Re, Re, Re^Edt, Re, Gs, Gs, Gs^Fds, Hh^Fds, Hh^Fds, Gs^Fds, Hh^Fds, Gs, Gs^Fds, Gs, Gs^Vl, Gg^Efm, Gg, Gg^Efm, Gg^Efm, Gs
Gs^Fms, Gs^Fms, Gs^Fms, Gs^Fms, Gg, Gs^Fms, Gg, Gll^Fp, Gg, Gg, Gg^Efm, Gg^Efm, Gs^Fds, Gs^Fds, Gs, Gs^Fms, Gs, Cer, Gll, Re, Re^Edt, Rb^Edt, Rb^Edt, Cer, Cer, Cer, Re^Edt, Rb^Edt, Gll^Edt, Gll^Edt, Gll, Cer, Gs, Gs^Gvs, Gs^Gvs, Gs^Gvs, Gs, Gs, Gg, Gg^Efm, Gg^Efm, Gg^Efm, Gs, Gg^Efm, Gs, Gg^Efm, Gs
Gg, Gg, Gg^Efm, Gs^Vl, Gg^Efm, Gg^Efm, Gg^Efm, Gg, Gg, Gg^Efm, Gg, Gg, Gs, Gs^Fds, Gs, Gs, Gs, Gs, Gll^Edt, Gll, Gll^Edt, Re^Edt, Rb, Rb, Rb, Rb, Rb, Re^Edt, Gll^Edt, Gs, Gs, Gll, Gs^Fds, Gs^Fds, Gs, Gs^Gvs, Gs, Gs, Gs, Gs, Gs^Fds, Gs, Gs^Fds, Gs, Gs, Gs, Gs^Fds
Gg, Gg^Efm, Gg^Efm, Gg^Efm, Gg, Gg^Efm, Gs^Fms, Gs^Fms, Gs^Fms, Gs^Fms, Gs^Fms, Gs, Gs, Gs, Gs, Gs, Gs, Gs, Gs, Gs, Gll, Cer, Gll, Re^Edt, Re, Re, Gll, Cer, Gll, Gs^Fms, Gs^Fms, Gs^Fds, Hh^Fds, Hh^Fds, Gs^Fds, Gs^Fds, Gs^Fds, Gs^Fds, Hh^Fds, Hh^Fds, Hh^Fds, Hh^Fds, Hh^Fms, Hh^Fds, Hh^Fms, Hh^Fds, Hh^Fms
Gs, Gg, Gs, Gg, Gs, Gg, Gs^Fms, Gs^Fms, Gs^Fms, Gs^Fms, Gs, Gs^Fms, Gs, Gs, Gs, Gs, Gs, Gs, Gs, Gs, Gs, Gll, Gs, Re, Re, Gll, Gs, Gll, Hh^Fms, Gs^Fms, Hh^Fms, Hh^Fms, Hh^Fms, Gs^Fds, Gs, Gs^Fds, Gs, Gs^Fds, Gs, Hh^Fms, Gs, Hh^Fms, Gs, Hh^Fms, Hh^Fms, Hh^Fms, Hh^Fms
